State,Year,Period,labor force,employment,unemployment,unemployment rate
Alabama,2016,Jan,2154139,2017494,136645,6.3
Alabama,2016,Feb,2173092,2036507,136585,6.3
Alabama,2016,Mar,2178100,2048857,129243,5.9
Alabama,2016,Apr,2172485,2057842,114643,5.3
Alabama,2016,May,2172351,2055990,116361,5.4
Alabama,2016,Jun,2187770,2050118,137652,6.3
Alabama,2016,Jul,2181286,2048809,132477,6.1
Alabama,2016,Aug,2173363,2042531,130832,6
Alabama,2016,Sep,2180137,2053023,127114,5.8
Alabama,2016,Oct,2193234,2064311,128923,5.9
Alabama,2016,Nov,2185027,2066835,118192,5.4
Alabama,2016,Dec,2175529,2057339,118190,5.4
Alabama,2017,Jan,2170033,2039891,130142,6
Alabama,2017,Feb,2184530,2060967,123563,5.7
Alabama,2017,Mar,2187194,2080167,107027,4.9
Alabama,2017,Apr,2179052,2090053,88999,4.1
Alabama,2017,May,2170221,2084139,86082,4
Alabama,2017,Jun,2188223,2082082,106141,4.9
Alabama,2017,Jul,2181845,2081390,100455,4.6
Alabama,2017,Aug,2168311,2074678,93633,4.3
Alabama,2017,Sep,2177756,2095965,81791,3.8
Alabama,2017,Oct,2181863,2099811,82052,3.8
Alabama,2017,Nov,2178785,2099675,79110,3.6
Alabama,2017,Dec,2171103,2091295,79808,3.7
Alabama,2018,Jan,2165702,2070910,94792,4.4
Alabama,2018,Feb,2195436,2098114,97322,4.4
Alabama,2018,Mar,2199359,2110535,88824,4
Alabama,2018,Apr,2195860,2120097,75763,3.5
Alabama,2018,May,2196747,2118570,78177,3.6
Alabama,2018,Jun,2220074,2116247,103827,4.7
Alabama,2018,Jul,2213762,2118899,94863,4.3
Alabama,2018,Aug,2189229,2098844,90385,4.1
Alabama,2018,Sep,2192040,2111440,80600,3.7
Alabama,2018,Oct,2212503,2130827,81676,3.7
Alabama,2018,Nov,2205363,2131646,73717,3.3
Alabama,2018,Dec,2199965,2122037,77928,3.5
Alabama,2019,Jan,2199521,2103819,95702,4.4
Alabama,2019,Feb,2220068,2132372,87696,4
Alabama,2019,Mar,2235701,2151836,83865,3.8
Alabama,2019,Apr,2247241,2172031,75210,3.3
Alabama,2019,May,2257212,2192484,64728,2.9
Alabama,2019,Jun,2262553,2184147,78406,3.5
Alabama,2019,Jul,2265650,2196781,68869,3
Alabama,2019,Aug,2263576,2199921,63655,2.8
Alabama,2019,Sep,2264263,2207339,56924,2.5
Alabama,2019,Oct,2269499,2214558,54941,2.4
Alaska,2016,Jan,357541,331012,26529,7.4
Alaska,2016,Feb,358652,331081,27571,7.7
Alaska,2016,Mar,358972,332250,26722,7.4
Alaska,2016,Apr,358677,333435,25242,7
Alaska,2016,May,363439,338743,24696,6.8
Alaska,2016,Jun,369135,343481,25654,6.9
Alaska,2016,Jul,372890,349587,23303,6.2
Alaska,2016,Aug,367989,345875,22114,6
Alaska,2016,Sep,362465,339594,22871,6.3
Alaska,2016,Oct,360023,336436,23587,6.6
Alaska,2016,Nov,359238,334412,24826,6.9
Alaska,2016,Dec,357754,332523,25231,7.1
Alaska,2017,Jan,356840,329272,27568,7.7
Alaska,2017,Feb,358300,330140,28160,7.9
Alaska,2017,Mar,358114,330925,27189,7.6
Alaska,2017,Apr,356901,331257,25644,7.2
Alaska,2017,May,362107,337224,24883,6.9
Alaska,2017,Jun,368617,342737,25880,7
Alaska,2017,Jul,371570,347869,23701,6.4
Alaska,2017,Aug,366630,344170,22460,6.1
Alaska,2017,Sep,361335,338427,22908,6.3
Alaska,2017,Oct,357933,334583,23350,6.5
Alaska,2017,Nov,356434,331950,24484,6.9
Alaska,2017,Dec,354321,329629,24692,7
Alaska,2018,Jan,353253,326567,26686,7.6
Alaska,2018,Feb,354403,327361,27042,7.6
Alaska,2018,Mar,354154,328217,25937,7.3
Alaska,2018,Apr,352637,328264,24373,6.9
Alaska,2018,May,357784,334386,23398,6.5
Alaska,2018,Jun,363950,339725,24225,6.7
Alaska,2018,Jul,367529,345527,22002,6
Alaska,2018,Aug,362321,341854,20467,5.6
Alaska,2018,Sep,357350,336243,21107,5.9
Alaska,2018,Oct,354262,332723,21539,6.1
Alaska,2018,Nov,353278,330621,22657,6.4
Alaska,2018,Dec,351704,329011,22693,6.5
Alaska,2019,Jan,348985,323145,25840,7.4
Alaska,2019,Feb,349442,323269,26173,7.5
Alaska,2019,Mar,350049,324828,25221,7.2
Alaska,2019,Apr,346904,324667,22237,6.4
Alaska,2019,May,350619,328891,21728,6.2
Alaska,2019,Jun,357246,335128,22118,6.2
Alaska,2019,Jul,361505,341545,19960,5.5
Alaska,2019,Aug,354793,336063,18730,5.3
Alaska,2019,Sep,349424,329750,19674,5.6
Alaska,2019,Oct,344026,324737,19289,5.6
Arizona,2016,Jan,3197292,3017653,179639,5.6
Arizona,2016,Feb,3213629,3043691,169938,5.3
Arizona,2016,Mar,3232871,3059742,173129,5.4
Arizona,2016,Apr,3219802,3049979,169823,5.3
Arizona,2016,May,3227035,3059491,167544,5.2
Arizona,2016,Jun,3236799,3051324,185475,5.7
Arizona,2016,Jul,3236030,3048217,187813,5.8
Arizona,2016,Aug,3242033,3056032,186001,5.7
Arizona,2016,Sep,3267354,3085042,182312,5.6
Arizona,2016,Oct,3269678,3096812,172866,5.3
Arizona,2016,Nov,3277836,3116538,161298,4.9
Arizona,2016,Dec,3266716,3107611,159105,4.9
Arizona,2017,Jan,3285494,3110779,174715,5.3
Arizona,2017,Feb,3301535,3135650,165885,5
Arizona,2017,Mar,3318319,3155494,162825,4.9
Arizona,2017,Apr,3311607,3156211,155396,4.7
Arizona,2017,May,3307729,3151399,156330,4.7
Arizona,2017,Jun,3320849,3152151,168698,5.1
Arizona,2017,Jul,3324471,3152238,172233,5.2
Arizona,2017,Aug,3326429,3153236,173193,5.2
Arizona,2017,Sep,3367685,3203111,164574,4.9
Arizona,2017,Oct,3349418,3194334,155084,4.6
Arizona,2017,Nov,3364792,3213123,151669,4.5
Arizona,2017,Dec,3357059,3203802,153257,4.6
Arizona,2018,Jan,3368475,3200622,167853,5
Arizona,2018,Feb,3400180,3239782,160398,4.7
Arizona,2018,Mar,3410192,3251740,158452,4.6
Arizona,2018,Apr,3399739,3247415,152324,4.5
Arizona,2018,May,3408074,3258214,149860,4.4
Arizona,2018,Jun,3427161,3254058,173103,5.1
Arizona,2018,Jul,3439400,3265387,174013,5.1
Arizona,2018,Aug,3431669,3254869,176800,5.2
Arizona,2018,Sep,3477406,3305922,171484,4.9
Arizona,2018,Oct,3491620,3321446,170174,4.9
Arizona,2018,Nov,3512594,3345872,166722,4.7
Arizona,2018,Dec,3510545,3337274,173271,4.9
Arizona,2019,Jan,3526503,3326647,199856,5.7
Arizona,2019,Feb,3512865,3348623,164242,4.7
Arizona,2019,Mar,3507158,3347257,159901,4.6
Arizona,2019,Apr,3484761,3336806,147955,4.2
Arizona,2019,May,3507197,3346382,160815,4.6
Arizona,2019,Jun,3566295,3377724,188571,5.3
Arizona,2019,Jul,3578913,3377310,201603,5.6
Arizona,2019,Aug,3578207,3379630,198577,5.5
Arizona,2019,Sep,3599212,3439209,160003,4.4
Arizona,2019,Oct,3599850,3444510,155340,4.3
Arkansas,2016,Jan,1314510,1252358,62152,4.7
Arkansas,2016,Feb,1330778,1269008,61770,4.6
Arkansas,2016,Mar,1336906,1281784,55122,4.1
Arkansas,2016,Apr,1338426,1290158,48268,3.6
Arkansas,2016,May,1342934,1291302,51632,3.8
Arkansas,2016,Jun,1358543,1300592,57951,4.3
Arkansas,2016,Jul,1358630,1299387,59243,4.4
Arkansas,2016,Aug,1345384,1292500,52884,3.9
Arkansas,2016,Sep,1346185,1295444,50741,3.8
Arkansas,2016,Oct,1342000,1296344,45656,3.4
Arkansas,2016,Nov,1336114,1292233,43881,3.3
Arkansas,2016,Dec,1329612,1281393,48219,3.6
Arkansas,2017,Jan,1319170,1262744,56426,4.3
Arkansas,2017,Feb,1335285,1279557,55728,4.2
Arkansas,2017,Mar,1340856,1292735,48121,3.6
Arkansas,2017,Apr,1346271,1302970,43301,3.2
Arkansas,2017,May,1350437,1302677,47760,3.5
Arkansas,2017,Jun,1368117,1313830,54287,4
Arkansas,2017,Jul,1366709,1310037,56672,4.1
Arkansas,2017,Aug,1353502,1301549,51953,3.8
Arkansas,2017,Sep,1355084,1306881,48203,3.6
Arkansas,2017,Oct,1350318,1306251,44067,3.3
Arkansas,2017,Nov,1346414,1302016,44398,3.3
Arkansas,2017,Dec,1339404,1290581,48823,3.6
Arkansas,2018,Jan,1327167,1269989,57178,4.3
Arkansas,2018,Feb,1344868,1287358,57510,4.3
Arkansas,2018,Mar,1348676,1297651,51025,3.8
Arkansas,2018,Apr,1349698,1304441,45257,3.4
Arkansas,2018,May,1353659,1306161,47498,3.5
Arkansas,2018,Jun,1368251,1313585,54666,4
Arkansas,2018,Jul,1368932,1313583,55349,4
Arkansas,2018,Aug,1352630,1303679,48951,3.6
Arkansas,2018,Sep,1353432,1306513,46919,3.5
Arkansas,2018,Oct,1355060,1310995,44065,3.3
Arkansas,2018,Nov,1351062,1307657,43405,3.2
Arkansas,2018,Dec,1344510,1295892,48618,3.6
Arkansas,2019,Jan,1337914,1278367,59547,4.5
Arkansas,2019,Feb,1355762,1296873,58889,4.3
Arkansas,2019,Mar,1357713,1311032,46681,3.4
Arkansas,2019,Apr,1359733,1320551,39182,2.9
Arkansas,2019,May,1367757,1324345,43412,3.2
Arkansas,2019,Jun,1382212,1332568,49644,3.6
Arkansas,2019,Jul,1381647,1327070,54577,4
Arkansas,2019,Aug,1359599,1310849,48750,3.6
Arkansas,2019,Sep,1363893,1318183,45710,3.4
Arkansas,2019,Oct,1371482,1327931,43551,3.2
California,2016,Jan,18874355,17760797,1113558,5.9
California,2016,Feb,18991826,17900506,1091320,5.7
California,2016,Mar,19037324,17938743,1098581,5.8
California,2016,Apr,18965602,17953653,1011949,5.3
California,2016,May,18963661,18018582,945079,5
California,2016,Jun,19034078,17969627,1064451,5.6
California,2016,Jul,19144384,18025835,1118549,5.8
California,2016,Aug,19110901,18035859,1075042,5.6
California,2016,Sep,19158374,18133964,1024410,5.3
California,2016,Oct,19142573,18126603,1015970,5.3
California,2016,Nov,19098800,18127451,971349,5.1
California,2016,Dec,19011773,18041655,970118,5.1
California,2017,Jan,19069395,18000904,1068491,5.6
California,2017,Feb,19168470,18137359,1031111,5.4
California,2017,Mar,19199954,18218548,981406,5.1
California,2017,Apr,19150275,18258751,891524,4.7
California,2017,May,19124562,18277128,847434,4.4
California,2017,Jun,19193777,18260927,932850,4.9
California,2017,Jul,19303152,18309383,993769,5.1
California,2017,Aug,19257179,18292720,964459,5
California,2017,Sep,19356268,18498740,857528,4.4
California,2017,Oct,19245488,18418630,826858,4.3
California,2017,Nov,19248368,18420643,827725,4.3
California,2017,Dec,19146656,18332173,814483,4.3
California,2018,Jan,19150411,18253152,897259,4.7
California,2018,Feb,19343020,18455821,887199,4.6
California,2018,Mar,19328608,18468825,859783,4.4
California,2018,Apr,19271108,18495218,775890,4
California,2018,May,19296206,18579087,717119,3.7
California,2018,Jun,19395567,18545426,850141,4.4
California,2018,Jul,19498176,18621343,876833,4.5
California,2018,Aug,19378108,18541395,836713,4.3
California,2018,Sep,19478378,18721770,756608,3.9
California,2018,Oct,19542699,18769910,772789,4
California,2018,Nov,19562413,18802126,760287,3.9
California,2018,Dec,19533844,18739549,794295,4.1
California,2019,Jan,19564158,18629056,935102,4.8
California,2019,Feb,19596296,18729028,867268,4.4
California,2019,Mar,19511569,18611047,900522,4.6
California,2019,Apr,19243469,18499551,743918,3.9
California,2019,May,19290164,18609242,680922,3.5
California,2019,Jun,19297350,18493874,803476,4.2
California,2019,Jul,19457570,18591573,865997,4.5
California,2019,Aug,19425066,18614774,810292,4.2
California,2019,Sep,19567536,18876677,690859,3.5
California,2019,Oct,19588210,18869015,719195,3.7
Colorado,2016,Jan,2843878,2737790,106088,3.7
Colorado,2016,Feb,2864461,2758032,106429,3.7
Colorado,2016,Mar,2871081,2764423,106658,3.7
Colorado,2016,Apr,2869017,2770865,98152,3.4
Colorado,2016,May,2874275,2781937,92338,3.2
Colorado,2016,Jun,2912654,2809151,103503,3.6
Colorado,2016,Jul,2917830,2823244,94586,3.2
Colorado,2016,Aug,2918542,2829349,89193,3.1
Colorado,2016,Sep,2925185,2839550,85635,2.9
Colorado,2016,Oct,2929024,2846913,82111,2.8
Colorado,2016,Nov,2919668,2841703,77965,2.7
Colorado,2016,Dec,2915634,2838277,77357,2.7
Colorado,2017,Jan,2924216,2831398,92818,3.2
Colorado,2017,Feb,2945602,2856895,88707,3
Colorado,2017,Mar,2952018,2871705,80313,2.7
Colorado,2017,Apr,2957983,2884665,73318,2.5
Colorado,2017,May,2966441,2892913,73528,2.5
Colorado,2017,Jun,3007314,2922810,84504,2.8
Colorado,2017,Jul,3019734,2938124,81610,2.7
Colorado,2017,Aug,3019660,2938313,81347,2.7
Colorado,2017,Sep,3035085,2956905,78180,2.6
Colorado,2017,Oct,3030716,2952217,78499,2.6
Colorado,2017,Nov,3027893,2946019,81874,2.7
Colorado,2017,Dec,3022280,2940987,81293,2.7
Colorado,2018,Jan,3025258,2928709,96549,3.2
Colorado,2018,Feb,3054983,2956755,98228,3.2
Colorado,2018,Mar,3056824,2961923,94901,3.1
Colorado,2018,Apr,3060983,2972229,88754,2.9
Colorado,2018,May,3071539,2985041,86498,2.8
Colorado,2018,Jun,3115771,3009178,106593,3.4
Colorado,2018,Jul,3126894,3022636,104258,3.3
Colorado,2018,Aug,3114611,3009272,105339,3.4
Colorado,2018,Sep,3124018,3022210,101808,3.3
Colorado,2018,Oct,3135286,3029063,106223,3.4
Colorado,2018,Nov,3133401,3022235,111166,3.5
Colorado,2018,Dec,3136729,3017773,118956,3.8
Colorado,2019,Jan,3118999,2986629,132370,4.2
Colorado,2019,Feb,3132592,3023083,109509,3.5
Colorado,2019,Mar,3123249,3029323,93926,3
Colorado,2019,Apr,3119039,3033703,85336,2.7
Colorado,2019,May,3127934,3048723,79211,2.5
Colorado,2019,Jun,3186284,3091365,94919,3
Colorado,2019,Jul,3189419,3101412,88007,2.8
Colorado,2019,Aug,3173865,3088538,85327,2.7
Colorado,2019,Sep,3177825,3107822,70003,2.2
Colorado,2019,Oct,3178231,3102421,75810,2.4
Connecticut,2016,Jan,1868440,1755711,112729,6
Connecticut,2016,Feb,1871389,1760786,110603,5.9
Connecticut,2016,Mar,1882784,1776624,106160,5.6
Connecticut,2016,Apr,1875671,1779670,96001,5.1
Connecticut,2016,May,1894689,1798152,96537,5.1
Connecticut,2016,Jun,1913953,1809593,104360,5.5
Connecticut,2016,Jul,1929834,1825371,104463,5.4
Connecticut,2016,Aug,1904549,1805643,98906,5.2
Connecticut,2016,Sep,1886449,1795582,90867,4.8
Connecticut,2016,Oct,1891098,1804858,86240,4.6
Connecticut,2016,Nov,1891443,1811359,80084,4.2
Connecticut,2016,Dec,1885005,1803498,81507,4.3
Connecticut,2017,Jan,1893110,1788718,104392,5.5
Connecticut,2017,Feb,1894159,1792869,101290,5.3
Connecticut,2017,Mar,1903114,1807307,95807,5
Connecticut,2017,Apr,1897520,1808552,88968,4.7
Connecticut,2017,May,1906706,1817812,88894,4.7
Connecticut,2017,Jun,1917843,1824958,92885,4.8
Connecticut,2017,Jul,1929901,1835283,94618,4.9
Connecticut,2017,Aug,1898380,1808703,89677,4.7
Connecticut,2017,Sep,1884729,1802192,82537,4.4
Connecticut,2017,Oct,1882350,1802082,80268,4.3
Connecticut,2017,Nov,1883097,1805605,77492,4.1
Connecticut,2017,Dec,1872342,1795992,76350,4.1
Connecticut,2018,Jan,1875313,1777502,97811,5.2
Connecticut,2018,Feb,1881241,1786801,94440,5
Connecticut,2018,Mar,1887096,1799048,88048,4.7
Connecticut,2018,Apr,1883037,1805086,77951,4.1
Connecticut,2018,May,1904223,1826151,78072,4.1
Connecticut,2018,Jun,1921741,1838143,83598,4.4
Connecticut,2018,Jul,1942125,1858724,83401,4.3
Connecticut,2018,Aug,1913198,1835710,77488,4.1
Connecticut,2018,Sep,1903862,1834171,69691,3.7
Connecticut,2018,Oct,1915336,1848653,66683,3.5
Connecticut,2018,Nov,1920441,1859963,60478,3.1
Connecticut,2018,Dec,1916138,1854892,61246,3.2
Connecticut,2019,Jan,1910715,1820517,90198,4.7
Connecticut,2019,Feb,1905164,1821487,83677,4.4
Connecticut,2019,Mar,1904314,1824892,79422,4.2
Connecticut,2019,Apr,1888547,1827003,61544,3.3
Connecticut,2019,May,1907631,1839534,68097,3.6
Connecticut,2019,Jun,1923951,1849896,74055,3.8
Connecticut,2019,Jul,1941247,1871451,69796,3.6
Connecticut,2019,Aug,1921604,1852676,68928,3.6
Connecticut,2019,Sep,1913778,1848172,65606,3.4
Connecticut,2019,Oct,1929565,1862336,67229,3.5
Delaware,2016,Jan,470120,446678,23442,5
Delaware,2016,Feb,469658,446714,22944,4.9
Delaware,2016,Mar,472344,450489,21855,4.6
Delaware,2016,Apr,472116,451444,20672,4.4
Delaware,2016,May,470541,450883,19658,4.2
Delaware,2016,Jun,476416,453394,23022,4.8
Delaware,2016,Jul,477538,455005,22533,4.7
Delaware,2016,Aug,474853,452853,22000,4.6
Delaware,2016,Sep,468115,447154,20961,4.5
Delaware,2016,Oct,470880,450357,20523,4.4
Delaware,2016,Nov,471717,452692,19025,4
Delaware,2016,Dec,472609,453274,19335,4.1
Delaware,2017,Jan,472349,448758,23591,5
Delaware,2017,Feb,472423,448929,23494,5
Delaware,2017,Mar,475202,452805,22397,4.7
Delaware,2017,Apr,475494,454202,21292,4.5
Delaware,2017,May,474370,454137,20233,4.3
Delaware,2017,Jun,481063,457689,23374,4.9
Delaware,2017,Jul,482606,459619,22987,4.8
Delaware,2017,Aug,480545,458212,22333,4.6
Delaware,2017,Sep,474399,453791,20608,4.3
Delaware,2017,Oct,476670,456891,19779,4.1
Delaware,2017,Nov,478056,459880,18176,3.8
Delaware,2017,Dec,478947,460949,17998,3.8
Delaware,2018,Jan,478391,456781,21610,4.5
Delaware,2018,Feb,478740,457809,20931,4.4
Delaware,2018,Mar,481405,461900,19505,4.1
Delaware,2018,Apr,481894,463842,18052,3.7
Delaware,2018,May,481259,464498,16761,3.5
Delaware,2018,Jun,487434,467375,20059,4.1
Delaware,2018,Jul,488284,468741,19543,4
Delaware,2018,Aug,485125,466346,18779,3.9
Delaware,2018,Sep,478645,461576,17069,3.6
Delaware,2018,Oct,481871,465770,16101,3.3
Delaware,2018,Nov,482804,468455,14349,3
Delaware,2018,Dec,483727,468945,14782,3.1
Delaware,2019,Jan,484820,466928,17892,3.7
Delaware,2019,Feb,485741,469101,16640,3.4
Delaware,2019,Mar,488474,472624,15850,3.2
Delaware,2019,Apr,489511,474638,14873,3
Delaware,2019,May,489148,474705,14443,3
Delaware,2019,Jun,492168,474360,17808,3.6
Delaware,2019,Jul,494172,475637,18535,3.8
Delaware,2019,Aug,491379,471425,19954,4.1
Delaware,2019,Sep,484873,466646,18227,3.8
Delaware,2019,Oct,490529,471769,18760,3.8
D.C.,2016,Jan,391707,366061,25646,6.5
D.C.,2016,Feb,394649,368971,25678,6.5
D.C.,2016,Mar,393825,369715,24110,6.1
D.C.,2016,Apr,394202,372652,21550,5.5
D.C.,2016,May,392602,370609,21993,5.6
D.C.,2016,Jun,397696,372161,25535,6.4
D.C.,2016,Jul,401703,375657,26046,6.5
D.C.,2016,Aug,394295,369227,25068,6.4
D.C.,2016,Sep,394221,369644,24577,6.2
D.C.,2016,Oct,396747,372938,23809,6
D.C.,2016,Nov,397488,374351,23137,5.8
D.C.,2016,Dec,395953,373554,22399,5.7
D.C.,2017,Jan,397860,373218,24642,6.2
D.C.,2017,Feb,400561,375528,25033,6.2
D.C.,2017,Mar,400363,376370,23993,6
D.C.,2017,Apr,399851,377621,22230,5.6
D.C.,2017,May,399741,376479,23262,5.8
D.C.,2017,Jun,404819,378201,26618,6.6
D.C.,2017,Jul,408330,381283,27047,6.6
D.C.,2017,Aug,400641,375043,25598,6.4
D.C.,2017,Sep,400364,375348,25016,6.2
D.C.,2017,Oct,401494,377732,23762,5.9
D.C.,2017,Nov,402305,379541,22764,5.7
D.C.,2017,Dec,401070,379474,21596,5.4
D.C.,2018,Jan,402925,379238,23687,5.9
D.C.,2018,Feb,406696,382573,24123,5.9
D.C.,2018,Mar,406065,382874,23191,5.7
D.C.,2018,Apr,405784,384850,20934,5.2
D.C.,2018,May,404595,383058,21537,5.3
D.C.,2018,Jun,408862,384262,24600,6
D.C.,2018,Jul,411058,386472,24586,6
D.C.,2018,Aug,401594,378443,23151,5.8
D.C.,2018,Sep,400542,378348,22194,5.5
D.C.,2018,Oct,402446,381131,21315,5.3
D.C.,2018,Nov,402811,382248,20563,5.1
D.C.,2018,Dec,401943,382184,19759,4.9
D.C.,2019,Jan,404656,380317,24339,6
D.C.,2019,Feb,407959,383439,24520,6
D.C.,2019,Mar,410240,387443,22797,5.6
D.C.,2019,Apr,412561,391633,20928,5.1
D.C.,2019,May,413491,391728,21763,5.3
D.C.,2019,Jun,415985,391618,24367,5.9
D.C.,2019,Jul,418613,393749,24864,5.9
D.C.,2019,Aug,407033,384949,22084,5.4
D.C.,2019,Sep,407982,386277,21705,5.3
D.C.,2019,Oct,408339,386504,21835,5.3
Florida,2016,Jan,9655665,9168650,487015,5
Florida,2016,Feb,9712983,9254386,458597,4.7
Florida,2016,Mar,9767369,9302580,464789,4.8
Florida,2016,Apr,9747828,9300654,447174,4.6
Florida,2016,May,9807758,9364906,442852,4.5
Florida,2016,Jun,9822067,9331110,490957,5
Florida,2016,Jul,9873145,9373702,499443,5.1
Florida,2016,Aug,9856069,9359536,496533,5
Florida,2016,Sep,9935279,9443518,491761,4.9
Florida,2016,Oct,9930935,9456306,474629,4.8
Florida,2016,Nov,9907167,9453211,453956,4.6
Florida,2016,Dec,9892050,9446155,445895,4.5
Florida,2017,Jan,9948919,9469923,478996,4.8
Florida,2017,Feb,10006609,9564337,442272,4.4
Florida,2017,Mar,10070431,9650133,420298,4.2
Florida,2017,Apr,10083503,9683950,399553,4
Florida,2017,May,10119039,9708108,410931,4.1
Florida,2017,Jun,10128259,9686562,441697,4.4
Florida,2017,Jul,10162351,9712231,450120,4.4
Florida,2017,Aug,10103658,9657342,446316,4.4
Florida,2017,Sep,10196648,9779590,417058,4.1
Florida,2017,Oct,10120729,9722177,398552,3.9
Florida,2017,Nov,10106066,9705844,400222,4
Florida,2017,Dec,10075202,9690539,384663,3.8
Florida,2018,Jan,10085897,9672168,413729,4.1
Florida,2018,Feb,10187885,9801852,386033,3.8
Florida,2018,Mar,10202284,9829173,373111,3.7
Florida,2018,Apr,10189508,9839843,349665,3.4
Florida,2018,May,10249456,9904441,345015,3.4
Florida,2018,Jun,10259091,9864306,394785,3.8
Florida,2018,Jul,10295785,9906767,389018,3.8
Florida,2018,Aug,10184034,9811220,372814,3.7
Florida,2018,Sep,10280409,9938333,342076,3.3
Florida,2018,Oct,10305265,9965187,340078,3.3
Florida,2018,Nov,10293133,9957217,335916,3.3
Florida,2018,Dec,10284492,9945570,338922,3.3
Florida,2019,Jan,10318862,9913729,405133,3.9
Florida,2019,Feb,10366434,10011644,354790,3.4
Florida,2019,Mar,10313367,9975155,338212,3.3
Florida,2019,Apr,10265561,9964712,300849,2.9
Florida,2019,May,10369102,10050309,318793,3.1
Florida,2019,Jun,10417225,10054403,362822,3.5
Florida,2019,Jul,10470206,10106827,363379,3.5
Florida,2019,Aug,10454907,10086438,368469,3.5
Florida,2019,Sep,10532471,10214776,317695,3
Florida,2019,Oct,10566507,10258909,307598,2.9
Georgia,2016,Jan,4831429,4563874,267555,5.5
Georgia,2016,Feb,4865727,4601571,264156,5.4
Georgia,2016,Mar,4893869,4632796,261073,5.3
Georgia,2016,Apr,4881565,4634445,247120,5.1
Georgia,2016,May,4903511,4658339,245172,5
Georgia,2016,Jun,4922799,4647052,275747,5.6
Georgia,2016,Jul,4956480,4672141,284339,5.7
Georgia,2016,Aug,4925235,4653600,271635,5.5
Georgia,2016,Sep,4955979,4686304,269675,5.4
Georgia,2016,Oct,4974178,4701004,273174,5.5
Georgia,2016,Nov,4970927,4722326,248601,5
Georgia,2016,Dec,4976185,4723178,253007,5.1
Georgia,2017,Jan,4995205,4725562,269643,5.4
Georgia,2017,Feb,5023297,4761382,261915,5.2
Georgia,2017,Mar,5046709,4804868,241841,4.8
Georgia,2017,Apr,5040667,4813589,227078,4.5
Georgia,2017,May,5049068,4819010,230058,4.6
Georgia,2017,Jun,5067481,4817096,250385,4.9
Georgia,2017,Jul,5092491,4840049,252442,5
Georgia,2017,Aug,5060026,4815335,244691,4.8
Georgia,2017,Sep,5097854,4875488,222366,4.4
Georgia,2017,Oct,5076609,4857176,219433,4.3
Georgia,2017,Nov,5079544,4870473,209071,4.1
Georgia,2017,Dec,5078566,4867128,211438,4.2
Georgia,2018,Jan,5079046,4852319,226727,4.5
Georgia,2018,Feb,5122823,4900790,222033,4.3
Georgia,2018,Mar,5121497,4914046,207451,4.1
Georgia,2018,Apr,5095818,4906347,189471,3.7
Georgia,2018,May,5106956,4920883,186073,3.6
Georgia,2018,Jun,5122210,4900767,221443,4.3
Georgia,2018,Jul,5137689,4920078,217611,4.2
Georgia,2018,Aug,5068005,4863640,204365,4
Georgia,2018,Sep,5090466,4908264,182202,3.6
Georgia,2018,Oct,5112773,4921011,191762,3.8
Georgia,2018,Nov,5111058,4935035,176023,3.4
Georgia,2018,Dec,5123539,4933757,189782,3.7
Georgia,2019,Jan,5116530,4887160,229370,4.5
Georgia,2019,Feb,5118857,4916668,202189,3.9
Georgia,2019,Mar,5110809,4922532,188277,3.7
Georgia,2019,Apr,5066227,4907178,159049,3.1
Georgia,2019,May,5102550,4926090,176460,3.5
Georgia,2019,Jun,5124710,4926706,198004,3.9
Georgia,2019,Jul,5130855,4940039,190816,3.7
Georgia,2019,Aug,5099799,4911313,188486,3.7
Georgia,2019,Sep,5112295,4955825,156470,3.1
Georgia,2019,Oct,5132608,4976331,156277,3
Hawaii,2016,Jan,679013,658149,20864,3.1
Hawaii,2016,Feb,677799,657854,19945,2.9
Hawaii,2016,Mar,680718,660453,20265,3
Hawaii,2016,Apr,680962,660901,20061,2.9
Hawaii,2016,May,680065,660095,19970,2.9
Hawaii,2016,Jun,685531,660983,24548,3.6
Hawaii,2016,Jul,688016,667265,20751,3
Hawaii,2016,Aug,685005,665298,19707,2.9
Hawaii,2016,Sep,683072,662377,20695,3
Hawaii,2016,Oct,682593,663280,19313,2.8
Hawaii,2016,Nov,687289,668028,19261,2.8
Hawaii,2016,Dec,685468,668723,16745,2.4
Hawaii,2017,Jan,688676,669245,19431,2.8
Hawaii,2017,Feb,686632,668666,17966,2.6
Hawaii,2017,Mar,688379,671038,17341,2.5
Hawaii,2017,Apr,687812,671043,16769,2.4
Hawaii,2017,May,684403,667963,16440,2.4
Hawaii,2017,Jun,687539,667089,20450,3
Hawaii,2017,Jul,687106,670668,16438,2.4
Hawaii,2017,Aug,680756,665394,15362,2.3
Hawaii,2017,Sep,677960,662044,15916,2.3
Hawaii,2017,Oct,675612,660923,14689,2.2
Hawaii,2017,Nov,679637,664345,15292,2.3
Hawaii,2017,Dec,678902,665694,13208,1.9
Hawaii,2018,Jan,680623,664879,15744,2.3
Hawaii,2018,Feb,679715,664606,15109,2.2
Hawaii,2018,Mar,681464,666401,15063,2.2
Hawaii,2018,Apr,680601,665912,14689,2.2
Hawaii,2018,May,678330,663324,15006,2.2
Hawaii,2018,Jun,682688,662103,20585,3
Hawaii,2018,Jul,682940,665759,17181,2.5
Hawaii,2018,Aug,677025,660383,16642,2.5
Hawaii,2018,Sep,673932,655752,18180,2.7
Hawaii,2018,Oct,673215,655810,17405,2.6
Hawaii,2018,Nov,678100,659813,18287,2.7
Hawaii,2018,Dec,676173,660788,15385,2.3
Hawaii,2019,Jan,672150,652747,19403,2.9
Hawaii,2019,Feb,668169,649760,18409,2.8
Hawaii,2019,Mar,668996,649804,19192,2.9
Hawaii,2019,Apr,665451,646692,18759,2.8
Hawaii,2019,May,660319,643143,17176,2.6
Hawaii,2019,Jun,662563,641188,21375,3.2
Hawaii,2019,Jul,661807,643964,17843,2.7
Hawaii,2019,Aug,656896,640094,16802,2.6
Hawaii,2019,Sep,657524,639284,18240,2.8
Hawaii,2019,Oct,663422,645934,17488,2.6
Idaho,2016,Jan,800450,760163,40287,5
Idaho,2016,Feb,804865,766450,38415,4.8
Idaho,2016,Mar,807438,770396,37042,4.6
Idaho,2016,Apr,807911,775517,32394,4
Idaho,2016,May,812930,784945,27985,3.4
Idaho,2016,Jun,823123,794192,28931,3.5
Idaho,2016,Jul,827153,798328,28825,3.5
Idaho,2016,Aug,820468,793147,27321,3.3
Idaho,2016,Sep,817966,791918,26048,3.2
Idaho,2016,Oct,820345,794760,25585,3.1
Idaho,2016,Nov,819470,790836,28634,3.5
Idaho,2016,Dec,818800,789408,29392,3.6
Idaho,2017,Jan,819071,782303,36768,4.5
Idaho,2017,Feb,822203,787297,34906,4.2
Idaho,2017,Mar,825474,792393,33081,4
Idaho,2017,Apr,825576,797511,28065,3.4
Idaho,2017,May,832138,808329,23809,2.9
Idaho,2017,Jun,843462,819139,24323,2.9
Idaho,2017,Jul,845458,821025,24433,2.9
Idaho,2017,Aug,839537,816523,23014,2.7
Idaho,2017,Sep,839069,817393,21676,2.6
Idaho,2017,Oct,841119,819681,21438,2.5
Idaho,2017,Nov,841224,816223,25001,3
Idaho,2017,Dec,842041,816013,26028,3.1
Idaho,2018,Jan,841944,808380,33564,4
Idaho,2018,Feb,846864,815106,31758,3.8
Idaho,2018,Mar,848084,817871,30213,3.6
Idaho,2018,Apr,849330,823696,25634,3
Idaho,2018,May,855937,834870,21067,2.5
Idaho,2018,Jun,866461,844517,21944,2.5
Idaho,2018,Jul,869908,848283,21625,2.5
Idaho,2018,Aug,861882,841551,20331,2.4
Idaho,2018,Sep,858931,840026,18905,2.2
Idaho,2018,Oct,862938,843718,19220,2.2
Idaho,2018,Nov,861411,838511,22900,2.7
Idaho,2018,Dec,860899,836259,24640,2.9
Idaho,2019,Jan,863966,828934,35032,4.1
Idaho,2019,Feb,867922,835843,32079,3.7
Idaho,2019,Mar,867630,838010,29620,3.4
Idaho,2019,Apr,868687,844994,23693,2.7
Idaho,2019,May,875121,854064,21057,2.4
Idaho,2019,Jun,888777,865680,23097,2.6
Idaho,2019,Jul,894455,869667,24788,2.8
Idaho,2019,Aug,888346,865008,23338,2.6
Idaho,2019,Sep,885920,865616,20304,2.3
Idaho,2019,Oct,888317,867599,20718,2.3
Illinois,2016,Jan,6525625,6090194,435431,6.7
Illinois,2016,Feb,6565165,6136724,428441,6.5
Illinois,2016,Mar,6589324,6172443,416881,6.3
Illinois,2016,Apr,6554467,6175066,379401,5.8
Illinois,2016,May,6546924,6200475,346449,5.3
Illinois,2016,Jun,6637173,6238202,398971,6
Illinois,2016,Jul,6626366,6241307,385059,5.8
Illinois,2016,Aug,6555341,6175243,380098,5.8
Illinois,2016,Sep,6519163,6157320,361843,5.6
Illinois,2016,Oct,6524093,6165417,358676,5.5
Illinois,2016,Nov,6492398,6162070,330328,5.1
Illinois,2016,Dec,6462121,6119829,342292,5.3
Illinois,2017,Jan,6458237,6062606,395631,6.1
Illinois,2017,Feb,6467499,6105972,361527,5.6
Illinois,2017,Mar,6475044,6156262,318782,4.9
Illinois,2017,Apr,6459278,6169858,289420,4.5
Illinois,2017,May,6460759,6176744,284015,4.4
Illinois,2017,Jun,6562400,6229982,332418,5.1
Illinois,2017,Jul,6570584,6236829,333755,5.1
Illinois,2017,Aug,6513347,6169124,344223,5.3
Illinois,2017,Sep,6500817,6202255,298562,4.6
Illinois,2017,Oct,6477651,6185520,292131,4.5
Illinois,2017,Nov,6482935,6194151,288784,4.5
Illinois,2017,Dec,6446796,6157254,289542,4.5
Illinois,2018,Jan,6416140,6087605,328535,5.1
Illinois,2018,Feb,6477500,6160961,316539,4.9
Illinois,2018,Mar,6467723,6186715,281008,4.3
Illinois,2018,Apr,6436374,6191359,245015,3.8
Illinois,2018,May,6451295,6215786,235509,3.7
Illinois,2018,Jun,6557489,6250946,306543,4.7
Illinois,2018,Jul,6556104,6263615,292489,4.5
Illinois,2018,Aug,6442739,6164454,278285,4.3
Illinois,2018,Sep,6435664,6187133,248531,3.9
Illinois,2018,Oct,6477162,6213931,263231,4.1
Illinois,2018,Nov,6468774,6209756,259018,4
Illinois,2018,Dec,6449049,6163561,285488,4.4
Illinois,2019,Jan,6430086,6092664,337422,5.2
Illinois,2019,Feb,6455651,6153128,302523,4.7
Illinois,2019,Mar,6470215,6180422,289793,4.5
Illinois,2019,Apr,6479288,6219981,259307,4
Illinois,2019,May,6463675,6230198,233477,3.6
Illinois,2019,Jun,6576829,6311488,265341,4
Illinois,2019,Jul,6592918,6314559,278359,4.2
Illinois,2019,Aug,6527270,6281272,245998,3.8
Illinois,2019,Sep,6482734,6252349,230385,3.6
Illinois,2019,Oct,6487355,6251883,235472,3.6
Indiana,2016,Jan,3289538,3124714,164824,5
Indiana,2016,Feb,3313360,3144113,169247,5.1
Indiana,2016,Mar,3334889,3166308,168581,5.1
Indiana,2016,Apr,3336907,3189817,147090,4.4
Indiana,2016,May,3346989,3207014,139975,4.2
Indiana,2016,Jun,3373917,3219930,153987,4.6
Indiana,2016,Jul,3366909,3218680,148229,4.4
Indiana,2016,Aug,3337512,3188904,148608,4.5
Indiana,2016,Sep,3322494,3187607,134887,4.1
Indiana,2016,Oct,3322663,3190049,132614,4
Indiana,2016,Nov,3311971,3184429,127542,3.9
Indiana,2016,Dec,3289568,3161214,128354,3.9
Indiana,2017,Jan,3299034,3151131,147903,4.5
Indiana,2017,Feb,3308303,3166770,141533,4.3
Indiana,2017,Mar,3316914,3195974,120940,3.6
Indiana,2017,Apr,3329141,3229500,99641,3
Indiana,2017,May,3344353,3236975,107378,3.2
Indiana,2017,Jun,3379055,3260575,118480,3.5
Indiana,2017,Jul,3371037,3249261,121776,3.6
Indiana,2017,Aug,3348360,3215415,132945,4
Indiana,2017,Sep,3346056,3235489,110567,3.3
Indiana,2017,Oct,3337872,3230696,107176,3.2
Indiana,2017,Nov,3339831,3230324,109507,3.3
Indiana,2017,Dec,3319899,3215269,104630,3.2
Indiana,2018,Jan,3317001,3196771,120230,3.6
Indiana,2018,Feb,3354634,3228322,126312,3.8
Indiana,2018,Mar,3365497,3246605,118892,3.5
Indiana,2018,Apr,3378799,3274179,104620,3.1
Indiana,2018,May,3404379,3295784,108595,3.2
Indiana,2018,Jun,3436719,3308678,128041,3.7
Indiana,2018,Jul,3425660,3304005,121655,3.6
Indiana,2018,Aug,3379958,3257223,122735,3.6
Indiana,2018,Sep,3370504,3266081,104423,3.1
Indiana,2018,Oct,3393074,3280583,112491,3.3
Indiana,2018,Nov,3387893,3276017,111876,3.3
Indiana,2018,Dec,3366433,3252706,113727,3.4
Indiana,2019,Jan,3391548,3253152,138396,4.1
Indiana,2019,Feb,3410854,3271372,139482,4.1
Indiana,2019,Mar,3418659,3284264,134395,3.9
Indiana,2019,Apr,3406980,3303027,103953,3.1
Indiana,2019,May,3368983,3270198,98785,2.9
Indiana,2019,Jun,3410149,3297023,113126,3.3
Indiana,2019,Jul,3421884,3299678,122206,3.6
Indiana,2019,Aug,3399531,3290414,109117,3.2
Indiana,2019,Sep,3366755,3271303,95452,2.8
Indiana,2019,Oct,3377838,3276391,101447,3
Iowa,2016,Jan,1690774,1615707,75067,4.4
Iowa,2016,Feb,1696612,1624225,72387,4.3
Iowa,2016,Mar,1695534,1629600,65934,3.9
Iowa,2016,Apr,1695780,1638335,57445,3.4
Iowa,2016,May,1692363,1636877,55486,3.3
Iowa,2016,Jun,1708830,1645307,63523,3.7
Iowa,2016,Jul,1715077,1653256,61821,3.6
Iowa,2016,Aug,1696384,1635123,61261,3.6
Iowa,2016,Sep,1689539,1633379,56160,3.3
Iowa,2016,Oct,1692427,1640780,51647,3.1
Iowa,2016,Nov,1682167,1631851,50316,3
Iowa,2016,Dec,1674182,1615394,58788,3.5
Iowa,2017,Jan,1669472,1597188,72284,4.3
Iowa,2017,Feb,1673315,1607198,66117,4
Iowa,2017,Mar,1673738,1614841,58897,3.5
Iowa,2017,Apr,1677883,1627758,50125,3
Iowa,2017,May,1674484,1626384,48100,2.9
Iowa,2017,Jun,1694856,1641374,53482,3.2
Iowa,2017,Jul,1700447,1649497,50950,3
Iowa,2017,Aug,1682043,1630322,51721,3.1
Iowa,2017,Sep,1679252,1633511,45741,2.7
Iowa,2017,Oct,1676616,1637958,38658,2.3
Iowa,2017,Nov,1671302,1631163,40139,2.4
Iowa,2017,Dec,1666776,1619451,47325,2.8
Iowa,2018,Jan,1665701,1605876,59825,3.6
Iowa,2018,Feb,1677441,1621427,56014,3.3
Iowa,2018,Mar,1677530,1626810,50720,3
Iowa,2018,Apr,1682952,1640006,42946,2.6
Iowa,2018,May,1682376,1646181,36195,2.2
Iowa,2018,Jun,1703561,1660030,43531,2.6
Iowa,2018,Jul,1708108,1667412,40696,2.4
Iowa,2018,Aug,1684312,1644050,40262,2.4
Iowa,2018,Sep,1684670,1649738,34932,2.1
Iowa,2018,Oct,1695446,1663922,31524,1.9
Iowa,2018,Nov,1691018,1659462,31556,1.9
Iowa,2018,Dec,1688961,1646440,42521,2.5
Iowa,2019,Jan,1690194,1634593,55601,3.3
Iowa,2019,Feb,1708614,1661828,46786,2.7
Iowa,2019,Mar,1714665,1667122,47543,2.8
Iowa,2019,Apr,1715300,1679115,36185,2.1
Iowa,2019,May,1714122,1677465,36657,2.1
Iowa,2019,Jun,1741626,1696304,45322,2.6
Iowa,2019,Jul,1759364,1712566,46798,2.7
Iowa,2019,Aug,1750210,1704650,45560,2.6
Iowa,2019,Sep,1758902,1720225,38677,2.2
Iowa,2019,Oct,1774385,1736217,38168,2.2
Kansas,2016,Jan,1482621,1420894,61727,4.2
Kansas,2016,Feb,1487334,1424692,62642,4.2
Kansas,2016,Mar,1484391,1423900,60491,4.1
Kansas,2016,Apr,1482062,1425985,56077,3.8
Kansas,2016,May,1477342,1421824,55518,3.8
Kansas,2016,Jun,1501424,1435737,65687,4.4
Kansas,2016,Jul,1505725,1434782,70943,4.7
Kansas,2016,Aug,1479774,1414653,65121,4.4
Kansas,2016,Sep,1478393,1420916,57477,3.9
Kansas,2016,Oct,1484477,1428143,56334,3.8
Kansas,2016,Nov,1484165,1430005,54160,3.6
Kansas,2016,Dec,1476149,1423669,52480,3.6
Kansas,2017,Jan,1471324,1410073,61251,4.2
Kansas,2017,Feb,1476026,1416348,59678,4
Kansas,2017,Mar,1473713,1418933,54780,3.7
Kansas,2017,Apr,1472996,1421686,51310,3.5
Kansas,2017,May,1470034,1418018,52016,3.5
Kansas,2017,Jun,1494458,1435911,58547,3.9
Kansas,2017,Jul,1501811,1438553,63258,4.2
Kansas,2017,Aug,1477264,1417821,59443,4
Kansas,2017,Sep,1476595,1428113,48482,3.3
Kansas,2017,Oct,1477968,1431613,46355,3.1
Kansas,2017,Nov,1479771,1432988,46783,3.2
Kansas,2017,Dec,1472602,1426636,45966,3.1
Kansas,2018,Jan,1467662,1412815,54847,3.7
Kansas,2018,Feb,1476578,1421510,55068,3.7
Kansas,2018,Mar,1473071,1421460,51611,3.5
Kansas,2018,Apr,1473239,1427006,46233,3.1
Kansas,2018,May,1472156,1425997,46159,3.1
Kansas,2018,Jun,1498096,1443282,54814,3.7
Kansas,2018,Jul,1503990,1446190,57800,3.8
Kansas,2018,Aug,1477155,1425372,51783,3.5
Kansas,2018,Sep,1478994,1434837,44157,3
Kansas,2018,Oct,1488086,1443218,44868,3
Kansas,2018,Nov,1490418,1446252,44166,3
Kansas,2018,Dec,1487183,1440699,46484,3.1
Kansas,2019,Jan,1478977,1422531,56446,3.8
Kansas,2019,Feb,1482112,1426917,55195,3.7
Kansas,2019,Mar,1472488,1418673,53815,3.7
Kansas,2019,Apr,1465858,1421426,44432,3
Kansas,2019,May,1470964,1423572,47392,3.2
Kansas,2019,Jun,1490656,1442009,48647,3.3
Kansas,2019,Jul,1502091,1445203,56888,3.8
Kansas,2019,Aug,1484513,1434112,50401,3.4
Kansas,2019,Sep,1491504,1450463,41041,2.8
Kansas,2019,Oct,1502927,1460245,42682,2.8
Kentucky,2016,Jan,1979658,1863445,116213,5.9
Kentucky,2016,Feb,1995213,1876278,118935,6
Kentucky,2016,Mar,2007859,1896175,111684,5.6
Kentucky,2016,Apr,2003375,1908386,94989,4.7
Kentucky,2016,May,2014082,1915273,98809,4.9
Kentucky,2016,Jun,2037930,1926415,111515,5.5
Kentucky,2016,Jul,2027715,1920453,107262,5.3
Kentucky,2016,Aug,2010633,1913450,97183,4.8
Kentucky,2016,Sep,2019379,1921489,97890,4.8
Kentucky,2016,Oct,2020112,1924113,95999,4.8
Kentucky,2016,Nov,2025153,1935123,90030,4.4
Kentucky,2016,Dec,2028204,1930209,97995,4.8
Kentucky,2017,Jan,2026682,1907496,119186,5.9
Kentucky,2017,Feb,2042533,1921646,120887,5.9
Kentucky,2017,Mar,2059701,1946783,112918,5.5
Kentucky,2017,Apr,2058718,1960311,98407,4.8
Kentucky,2017,May,2060810,1958799,102011,5
Kentucky,2017,Jun,2085695,1971442,114253,5.5
Kentucky,2017,Jul,2070753,1959630,111123,5.4
Kentucky,2017,Aug,2045799,1948521,97278,4.8
Kentucky,2017,Sep,2056663,1967957,88706,4.3
Kentucky,2017,Oct,2043826,1960333,83493,4.1
Kentucky,2017,Nov,2049032,1969548,79484,3.9
Kentucky,2017,Dec,2044875,1963923,80952,4
Kentucky,2018,Jan,2033122,1934981,98141,4.8
Kentucky,2018,Feb,2057658,1953855,103803,5
Kentucky,2018,Mar,2068027,1970862,97165,4.7
Kentucky,2018,Apr,2066323,1982478,83845,4.1
Kentucky,2018,May,2074587,1985806,88781,4.3
Kentucky,2018,Jun,2098389,1996404,101985,4.9
Kentucky,2018,Jul,2082225,1983762,98463,4.7
Kentucky,2018,Aug,2045596,1961059,84537,4.1
Kentucky,2018,Sep,2054993,1970431,84562,4.1
Kentucky,2018,Oct,2050539,1971276,79263,3.9
Kentucky,2018,Nov,2054178,1981873,72305,3.5
Kentucky,2018,Dec,2053820,1974952,78868,3.8
Kentucky,2019,Jan,2047825,1956371,91454,4.5
Kentucky,2019,Feb,2057594,1969140,88454,4.3
Kentucky,2019,Mar,2078153,1985036,93117,4.5
Kentucky,2019,Apr,2068819,1988524,80295,3.9
Kentucky,2019,May,2081287,1998012,83275,4
Kentucky,2019,Jun,2095169,1992985,102184,4.9
Kentucky,2019,Jul,2085731,1978346,107385,5.1
Kentucky,2019,Aug,2068539,1978363,90176,4.4
Kentucky,2019,Sep,2070290,1991894,78396,3.8
Kentucky,2019,Oct,2074332,1996697,77635,3.7
Louisiana,2016,Jan,2112825,1979176,133649,6.3
Louisiana,2016,Feb,2115997,1994312,121685,5.8
Louisiana,2016,Mar,2130719,2002879,127840,6
Louisiana,2016,Apr,2130699,2008952,121747,5.7
Louisiana,2016,May,2125589,2002396,123193,5.8
Louisiana,2016,Jun,2152173,2003371,148802,6.9
Louisiana,2016,Jul,2150046,2006211,143835,6.7
Louisiana,2016,Aug,2117984,1978765,139219,6.6
Louisiana,2016,Sep,2118329,1982785,135544,6.4
Louisiana,2016,Oct,2113905,1990592,123313,5.8
Louisiana,2016,Nov,2102407,1989633,112774,5.4
Louisiana,2016,Dec,2082182,1972425,109757,5.3
Louisiana,2017,Jan,2078546,1951411,127135,6.1
Louisiana,2017,Feb,2086823,1974526,112297,5.4
Louisiana,2017,Mar,2097874,1987356,110518,5.3
Louisiana,2017,Apr,2102533,1997608,104925,5
Louisiana,2017,May,2098388,1991881,106507,5.1
Louisiana,2017,Jun,2127125,2001501,125624,5.9
Louisiana,2017,Jul,2128306,2008434,119872,5.6
Louisiana,2017,Aug,2109195,1991587,117608,5.6
Louisiana,2017,Sep,2110752,2006696,104056,4.9
Louisiana,2017,Oct,2106260,2015202,91058,4.3
Louisiana,2017,Nov,2107620,2018695,88925,4.2
Louisiana,2017,Dec,2090223,2006425,83798,4
Louisiana,2018,Jan,2079859,1978655,101204,4.9
Louisiana,2018,Feb,2092235,2000119,92116,4.4
Louisiana,2018,Mar,2104316,2007408,96908,4.6
Louisiana,2018,Apr,2106197,2011829,94368,4.5
Louisiana,2018,May,2104962,2004827,100135,4.8
Louisiana,2018,Jun,2138528,2007861,130667,6.1
Louisiana,2018,Jul,2135050,2013675,121375,5.7
Louisiana,2018,Aug,2099916,1985692,114224,5.4
Louisiana,2018,Sep,2093336,1990366,102970,4.9
Louisiana,2018,Oct,2105178,2008105,97073,4.6
Louisiana,2018,Nov,2098944,2008585,90359,4.3
Louisiana,2018,Dec,2083413,1992366,91047,4.4
Louisiana,2019,Jan,2081782,1974283,107499,5.2
Louisiana,2019,Feb,2087378,1995463,91915,4.4
Louisiana,2019,Mar,2090703,2010299,80404,3.8
Louisiana,2019,Apr,2088457,2015812,72645,3.5
Louisiana,2019,May,2093896,2008023,85873,4.1
Louisiana,2019,Jun,2127442,2014288,113154,5.3
Louisiana,2019,Jul,2119442,2009273,110169,5.2
Louisiana,2019,Aug,2089949,1987562,102387,4.9
Louisiana,2019,Sep,2095218,2000060,95158,4.5
Louisiana,2019,Oct,2101385,2002468,98917,4.7
Maine,2016,Jan,673597,641475,32122,4.8
Maine,2016,Feb,675163,642928,32235,4.8
Maine,2016,Mar,678962,647348,31614,4.7
Maine,2016,Apr,681981,653716,28265,4.1
Maine,2016,May,686227,660324,25903,3.8
Maine,2016,Jun,701530,675935,25595,3.6
Maine,2016,Jul,711590,686225,25365,3.6
Maine,2016,Aug,710609,688698,21911,3.1
Maine,2016,Sep,693980,672422,21558,3.1
Maine,2016,Oct,697617,675830,21787,3.1
Maine,2016,Nov,692302,668258,24044,3.5
Maine,2016,Dec,691203,667587,23616,3.4
Maine,2017,Jan,688914,658941,29973,4.4
Maine,2017,Feb,688319,658430,29889,4.3
Maine,2017,Mar,691339,662407,28932,4.2
Maine,2017,Apr,692044,666186,25858,3.7
Maine,2017,May,695120,670963,24157,3.5
Maine,2017,Jun,709742,686129,23613,3.3
Maine,2017,Jul,717033,693945,23088,3.2
Maine,2017,Aug,714714,695154,19560,2.7
Maine,2017,Sep,698120,679464,18656,2.7
Maine,2017,Oct,699630,680901,18729,2.7
Maine,2017,Nov,693509,672440,21069,3
Maine,2017,Dec,692538,672035,20503,3
Maine,2018,Jan,688849,661813,27036,3.9
Maine,2018,Feb,689944,662422,27522,4
Maine,2018,Mar,691740,664603,27137,3.9
Maine,2018,Apr,693112,668610,24502,3.5
Maine,2018,May,696513,673639,22874,3.3
Maine,2018,Jun,710735,687449,23286,3.3
Maine,2018,Jul,717755,694483,23272,3.2
Maine,2018,Aug,713770,693631,20139,2.8
Maine,2018,Sep,697191,677401,19790,2.8
Maine,2018,Oct,699745,679245,20500,2.9
Maine,2018,Nov,693756,670720,23036,3.3
Maine,2018,Dec,691825,668637,23188,3.4
Maine,2019,Jan,688885,659258,29627,4.3
Maine,2019,Feb,687164,660228,26936,3.9
Maine,2019,Mar,687474,661192,26282,3.8
Maine,2019,Apr,686294,662488,23806,3.5
Maine,2019,May,688858,666468,22390,3.3
Maine,2019,Jun,702161,682539,19622,2.8
Maine,2019,Jul,707709,690925,16784,2.4
Maine,2019,Aug,706577,691876,14701,2.1
Maine,2019,Sep,688370,672864,15506,2.3
Maine,2019,Oct,692566,676180,16386,2.4
Maryland,2016,Jan,3127299,2974263,153036,4.9
Maryland,2016,Feb,3129719,2978888,150831,4.8
Maryland,2016,Mar,3142915,2998985,143930,4.6
Maryland,2016,Apr,3132021,3003027,128994,4.1
Maryland,2016,May,3142116,3011259,130857,4.2
Maryland,2016,Jun,3179677,3031359,148318,4.7
Maryland,2016,Jul,3208444,3059409,149035,4.6
Maryland,2016,Aug,3176583,3031887,144696,4.6
Maryland,2016,Sep,3167010,3029659,137351,4.3
Maryland,2016,Oct,3178075,3038458,139617,4.4
Maryland,2016,Nov,3172024,3038269,133755,4.2
Maryland,2016,Dec,3164962,3034337,130625,4.1
Maryland,2017,Jan,3166623,3014640,151983,4.8
Maryland,2017,Feb,3167682,3020970,146712,4.6
Maryland,2017,Mar,3179654,3043415,136239,4.3
Maryland,2017,Apr,3173936,3049724,124212,3.9
Maryland,2017,May,3181279,3053897,127382,4
Maryland,2017,Jun,3220555,3077136,143419,4.5
Maryland,2017,Jul,3245185,3102196,142989,4.4
Maryland,2017,Aug,3208105,3068815,139290,4.3
Maryland,2017,Sep,3200864,3073218,127646,4
Maryland,2017,Oct,3200206,3069686,130520,4.1
Maryland,2017,Nov,3195822,3063865,131957,4.1
Maryland,2017,Dec,3181931,3054514,127417,4
Maryland,2018,Jan,3177233,3031194,146039,4.6
Maryland,2018,Feb,3187022,3044102,142920,4.5
Maryland,2018,Mar,3191821,3059661,132160,4.1
Maryland,2018,Apr,3179675,3062523,117152,3.7
Maryland,2018,May,3191396,3071701,119695,3.8
Maryland,2018,Jun,3228147,3090567,137580,4.3
Maryland,2018,Jul,3250426,3115752,134674,4.1
Maryland,2018,Aug,3200076,3073160,126916,4
Maryland,2018,Sep,3185520,3072058,113462,3.6
Maryland,2018,Oct,3198764,3083480,115284,3.6
Maryland,2018,Nov,3191352,3081449,109903,3.4
Maryland,2018,Dec,3184211,3074176,110035,3.5
Maryland,2019,Jan,3191193,3055513,135680,4.3
Maryland,2019,Feb,3200023,3067830,132193,4.1
Maryland,2019,Mar,3206056,3082048,124008,3.9
Maryland,2019,Apr,3194480,3087151,107329,3.4
Maryland,2019,May,3219361,3105471,113890,3.5
Maryland,2019,Jun,3271812,3142775,129037,3.9
Maryland,2019,Jul,3308228,3176969,131259,4
Maryland,2019,Aug,3286650,3160230,126420,3.8
Maryland,2019,Sep,3266964,3157766,109198,3.3
Maryland,2019,Oct,3297387,3190932,106455,3.2
Massachusetts,2016,Jan,3570271,3397544,172727,4.8
Massachusetts,2016,Feb,3584958,3420548,164410,4.6
Massachusetts,2016,Mar,3600484,3444303,156181,4.3
Massachusetts,2016,Apr,3592979,3458216,134763,3.8
Massachusetts,2016,May,3595127,3461424,133703,3.7
Massachusetts,2016,Jun,3657885,3510809,147076,4
Massachusetts,2016,Jul,3676284,3528906,147378,4
Massachusetts,2016,Aug,3664808,3532369,132439,3.6
Massachusetts,2016,Sep,3606977,3476146,130831,3.6
Massachusetts,2016,Oct,3623185,3502332,120853,3.3
Massachusetts,2016,Nov,3631718,3513295,118423,3.3
Massachusetts,2016,Dec,3631534,3507325,124209,3.4
Massachusetts,2017,Jan,3642276,3481808,160468,4.4
Massachusetts,2017,Feb,3661593,3503573,158020,4.3
Massachusetts,2017,Mar,3677411,3530230,147181,4
Massachusetts,2017,Apr,3670502,3541634,128868,3.5
Massachusetts,2017,May,3671972,3535314,136658,3.7
Massachusetts,2017,Jun,3734646,3584142,150504,4
Massachusetts,2017,Jul,3750958,3598633,152325,4.1
Massachusetts,2017,Aug,3736156,3596514,139642,3.7
Massachusetts,2017,Sep,3687683,3555552,132131,3.6
Massachusetts,2017,Oct,3693960,3574417,119543,3.2
Massachusetts,2017,Nov,3710910,3590981,119929,3.2
Massachusetts,2017,Dec,3713862,3591656,122206,3.3
Massachusetts,2018,Jan,3724639,3570387,154252,4.1
Massachusetts,2018,Feb,3759467,3607797,151670,4
Massachusetts,2018,Mar,3775360,3633708,141652,3.8
Massachusetts,2018,Apr,3777446,3654197,123249,3.3
Massachusetts,2018,May,3789870,3665310,124560,3.3
Massachusetts,2018,Jun,3859080,3715387,143693,3.7
Massachusetts,2018,Jul,3874598,3733785,140813,3.6
Massachusetts,2018,Aug,3847405,3723265,124140,3.2
Massachusetts,2018,Sep,3795770,3680389,115381,3
Massachusetts,2018,Oct,3817350,3712996,104354,2.7
Massachusetts,2018,Nov,3823218,3724395,98823,2.6
Massachusetts,2018,Dec,3821194,3719204,101990,2.7
Massachusetts,2019,Jan,3834176,3694718,139458,3.6
Massachusetts,2019,Feb,3833572,3710972,122600,3.2
Massachusetts,2019,Mar,3833122,3713570,119552,3.1
Massachusetts,2019,Apr,3814093,3714534,99559,2.6
Massachusetts,2019,May,3836848,3717195,119653,3.1
Massachusetts,2019,Jun,3878396,3756472,121924,3.1
Massachusetts,2019,Jul,3871993,3759292,112701,2.9
Massachusetts,2019,Aug,3886911,3776766,110145,2.8
Massachusetts,2019,Sep,3816437,3705844,110593,2.9
Massachusetts,2019,Oct,3840687,3746093,94594,2.5
Michigan,2016,Jan,4756888,4509241,247647,5.2
Michigan,2016,Feb,4803487,4553905,249582,5.2
Michigan,2016,Mar,4830858,4573759,257099,5.3
Michigan,2016,Apr,4803035,4581365,221670,4.6
Michigan,2016,May,4843885,4626632,217253,4.5
Michigan,2016,Jun,4891072,4640560,250512,5.1
Michigan,2016,Jul,4910027,4627113,282914,5.8
Michigan,2016,Aug,4893875,4637433,256442,5.2
Michigan,2016,Sep,4869794,4630227,239567,4.9
Michigan,2016,Oct,4876171,4637772,238399,4.9
Michigan,2016,Nov,4856563,4645327,211236,4.3
Michigan,2016,Dec,4841368,4616967,224401,4.6
Michigan,2017,Jan,4836132,4564623,271509,5.6
Michigan,2017,Feb,4870718,4606821,263897,5.4
Michigan,2017,Mar,4867045,4638205,228840,4.7
Michigan,2017,Apr,4836273,4652055,184218,3.8
Michigan,2017,May,4869139,4681697,187442,3.8
Michigan,2017,Jun,4920473,4700188,220285,4.5
Michigan,2017,Jul,4945145,4676966,268179,5.4
Michigan,2017,Aug,4926353,4678887,247466,5
Michigan,2017,Sep,4920007,4699318,220689,4.5
Michigan,2017,Oct,4889895,4684692,205203,4.2
Michigan,2017,Nov,4883754,4688054,195700,4
Michigan,2017,Dec,4868096,4657005,211091,4.3
Michigan,2018,Jan,4841938,4594760,247178,5.1
Michigan,2018,Feb,4902969,4661719,241250,4.9
Michigan,2018,Mar,4899905,4677427,222478,4.5
Michigan,2018,Apr,4865880,4685595,180285,3.7
Michigan,2018,May,4907004,4733664,173340,3.5
Michigan,2018,Jun,4960063,4744534,215529,4.3
Michigan,2018,Jul,4962680,4725287,237393,4.8
Michigan,2018,Aug,4902292,4703134,199158,4.1
Michigan,2018,Sep,4882449,4709818,172631,3.5
Michigan,2018,Oct,4909341,4728045,181296,3.7
Michigan,2018,Nov,4893580,4726807,166773,3.4
Michigan,2018,Dec,4896726,4695350,201376,4.1
Michigan,2019,Jan,4905115,4680497,224618,4.6
Michigan,2019,Feb,4938198,4735966,202232,4.1
Michigan,2019,Mar,4950462,4731104,219358,4.4
Michigan,2019,Apr,4926510,4742904,183606,3.7
Michigan,2019,May,4953458,4758593,194865,3.9
Michigan,2019,Jun,5006733,4788324,218409,4.4
Michigan,2019,Jul,5025280,4770836,254444,5.1
Michigan,2019,Aug,4984864,4776588,208276,4.2
Michigan,2019,Sep,4943788,4759129,184659,3.7
Michigan,2019,Oct,4938576,4764524,174052,3.5
Minnesota,2016,Jan,3002875,2867453,135422,4.5
Minnesota,2016,Feb,3015386,2880353,135033,4.5
Minnesota,2016,Mar,3022550,2884947,137603,4.6
Minnesota,2016,Apr,3017603,2905927,111676,3.7
Minnesota,2016,May,3021412,2924114,97298,3.2
Minnesota,2016,Jun,3052392,2931197,121195,4
Minnesota,2016,Jul,3063547,2947258,116289,3.8
Minnesota,2016,Aug,3050542,2934365,116177,3.8
Minnesota,2016,Sep,3036577,2928481,108096,3.6
Minnesota,2016,Oct,3043057,2939349,103708,3.4
Minnesota,2016,Nov,3035010,2935991,99019,3.3
Minnesota,2016,Dec,3039922,2916808,123114,4
Minnesota,2017,Jan,3034152,2891280,142872,4.7
Minnesota,2017,Feb,3040276,2904481,135795,4.5
Minnesota,2017,Mar,3042364,2916769,125595,4.1
Minnesota,2017,Apr,3046254,2942194,104060,3.4
Minnesota,2017,May,3051121,2957537,93584,3.1
Minnesota,2017,Jun,3078739,2973071,105668,3.4
Minnesota,2017,Jul,3088359,2987718,100641,3.3
Minnesota,2017,Aug,3073089,2971416,101673,3.3
Minnesota,2017,Sep,3062376,2976851,85525,2.8
Minnesota,2017,Oct,3053486,2982318,71168,2.3
Minnesota,2017,Nov,3058978,2976949,82029,2.7
Minnesota,2017,Dec,3054981,2954936,100045,3.3
Minnesota,2018,Jan,3042812,2924144,118668,3.9
Minnesota,2018,Feb,3058954,2942711,116243,3.8
Minnesota,2018,Mar,3056957,2945797,111160,3.6
Minnesota,2018,Apr,3060343,2967569,92774,3
Minnesota,2018,May,3062860,2990284,72576,2.4
Minnesota,2018,Jun,3090901,3000712,90189,2.9
Minnesota,2018,Jul,3100442,3017308,83134,2.7
Minnesota,2018,Aug,3073160,2992833,80327,2.6
Minnesota,2018,Sep,3062746,2992469,70277,2.3
Minnesota,2018,Oct,3077928,3009195,68733,2.2
Minnesota,2018,Nov,3073359,3004071,69288,2.3
Minnesota,2018,Dec,3082219,2983526,98693,3.2
Minnesota,2019,Jan,3077490,2945603,131887,4.3
Minnesota,2019,Feb,3082754,2960882,121872,4
Minnesota,2019,Mar,3089665,2962208,127457,4.1
Minnesota,2019,Apr,3088291,2986948,101343,3.3
Minnesota,2019,May,3096170,3008664,87506,2.8
Minnesota,2019,Jun,3132805,3026755,106050,3.4
Minnesota,2019,Jul,3156133,3051742,104391,3.3
Minnesota,2019,Aug,3130150,3036202,93948,3
Minnesota,2019,Sep,3122799,3045329,77470,2.5
Minnesota,2019,Oct,3138147,3058277,79870,2.5
mississippi,2016,Jan,1268586,1187426,81160,6.4
mississippi,2016,Feb,1277017,1201045,75972,5.9
mississippi,2016,Mar,1276175,1203506,72669,5.7
mississippi,2016,Apr,1273111,1205054,68057,5.3
mississippi,2016,May,1283106,1205680,77426,6
mississippi,2016,Jun,1292846,1204282,88564,6.9
mississippi,2016,Jul,1294090,1210743,83347,6.4
mississippi,2016,Aug,1272563,1199899,72664,5.7
mississippi,2016,Sep,1276832,1207233,69599,5.5
mississippi,2016,Oct,1278696,1210335,68361,5.3
mississippi,2016,Nov,1279594,1215137,64457,5
mississippi,2016,Dec,1280657,1211962,68695,5.4
mississippi,2017,Jan,1273149,1199206,73943,5.8
mississippi,2017,Feb,1280016,1212765,67251,5.3
mississippi,2017,Mar,1281574,1217663,63911,5
mississippi,2017,Apr,1280383,1220964,59419,4.6
mississippi,2017,May,1286074,1217639,68435,5.3
mississippi,2017,Jun,1296136,1217484,78652,6.1
mississippi,2017,Jul,1294339,1220253,74086,5.7
mississippi,2017,Aug,1272236,1207641,64595,5.1
mississippi,2017,Sep,1277754,1218040,59714,4.7
mississippi,2017,Oct,1271640,1214871,56769,4.5
mississippi,2017,Nov,1276093,1219379,56714,4.4
mississippi,2017,Dec,1277394,1217665,59729,4.7
mississippi,2018,Jan,1263891,1199029,64862,5.1
mississippi,2018,Feb,1276208,1213761,62447,4.9
mississippi,2018,Mar,1276084,1216835,59249,4.6
mississippi,2018,Apr,1275083,1219915,55168,4.3
mississippi,2018,May,1282966,1220680,62286,4.9
mississippi,2018,Jun,1293422,1218873,74549,5.8
mississippi,2018,Jul,1289979,1221400,68579,5.3
mississippi,2018,Aug,1262141,1203958,58183,4.6
mississippi,2018,Sep,1265313,1210413,54900,4.3
mississippi,2018,Oct,1270344,1215792,54552,4.3
mississippi,2018,Nov,1274959,1221169,53790,4.2
mississippi,2018,Dec,1278260,1218073,60187,4.7
mississippi,2019,Jan,1254398,1189391,65007,5.2
mississippi,2019,Feb,1254627,1193846,60781,4.8
mississippi,2019,Mar,1260142,1199282,60860,4.8
mississippi,2019,Apr,1265787,1206851,58936,4.7
mississippi,2019,May,1281495,1218592,62903,4.9
mississippi,2019,Jun,1298941,1221059,77882,6
mississippi,2019,Jul,1307754,1228160,79594,6.1
mississippi,2019,Aug,1285260,1212747,72513,5.6
mississippi,2019,Sep,1289580,1217838,71742,5.6
mississippi,2019,Oct,1283688,1217198,66490,5.2
Missouri,2016,Jan,3057493,2916814,140679,4.6
Missouri,2016,Feb,3078506,2928108,150398,4.9
Missouri,2016,Mar,3088334,2937642,150692,4.9
Missouri,2016,Apr,3089924,2955094,134830,4.4
Missouri,2016,May,3087918,2957789,130129,4.2
Missouri,2016,Jun,3125788,2971994,153794,4.9
Missouri,2016,Jul,3120391,2955083,165308,5.3
Missouri,2016,Aug,3084919,2921213,163706,5.3
Missouri,2016,Sep,3078152,2935550,142602,4.6
Missouri,2016,Oct,3071956,2947246,124710,4.1
Missouri,2016,Nov,3047078,2935329,111749,3.7
Missouri,2016,Dec,3039742,2921908,117834,3.9
Missouri,2017,Jan,3037898,2900928,136970,4.5
Missouri,2017,Feb,3057743,2915415,142328,4.7
Missouri,2017,Mar,3060124,2932790,127334,4.2
Missouri,2017,Apr,3071458,2960904,110554,3.6
Missouri,2017,May,3071235,2958650,112585,3.7
Missouri,2017,Jun,3094621,2978195,116426,3.8
Missouri,2017,Jul,3099061,2969280,129781,4.2
Missouri,2017,Aug,3061683,2930931,130752,4.3
Missouri,2017,Sep,3063697,2964289,99408,3.2
Missouri,2017,Oct,3044920,2962144,82776,2.7
Missouri,2017,Nov,3042220,2948616,93604,3.1
Missouri,2017,Dec,3032631,2933943,98688,3.3
Missouri,2018,Jan,3022409,2906485,115924,3.8
Missouri,2018,Feb,3052969,2931088,121881,4
Missouri,2018,Mar,3055283,2941745,113538,3.7
Missouri,2018,Apr,3058829,2968143,90686,3
Missouri,2018,May,3061364,2970092,91272,3
Missouri,2018,Jun,3091884,2985128,106756,3.5
Missouri,2018,Jul,3091337,2979150,112187,3.6
Missouri,2018,Aug,3028933,2927975,100958,3.3
Missouri,2018,Sep,3034664,2956179,78485,2.6
Missouri,2018,Oct,3045583,2975124,70459,2.3
Missouri,2018,Nov,3039341,2963748,75593,2.5
Missouri,2018,Dec,3046032,2952840,93192,3.1
Missouri,2019,Jan,3026545,2912618,113927,3.8
Missouri,2019,Feb,3045104,2932228,112876,3.7
Missouri,2019,Mar,3041341,2923504,117837,3.9
Missouri,2019,Apr,3036167,2949191,86976,2.9
Missouri,2019,May,3061289,2966451,94838,3.1
Missouri,2019,Jun,3114443,3006712,107731,3.5
Missouri,2019,Jul,3136860,3020420,116440,3.7
Missouri,2019,Aug,3105304,3000530,104774,3.4
Missouri,2019,Sep,3125516,3051696,73820,2.4
Missouri,2019,Oct,3141604,3062448,79156,2.5
Montana,2016,Jan,515999,488653,27346,5.3
Montana,2016,Feb,517147,491203,25944,5
Montana,2016,Mar,519539,494117,25422,4.9
Montana,2016,Apr,520127,498882,21245,4.1
Montana,2016,May,522169,502821,19348,3.7
Montana,2016,Jun,529225,507202,22023,4.2
Montana,2016,Jul,531706,511583,20123,3.8
Montana,2016,Aug,529087,509826,19261,3.6
Montana,2016,Sep,521460,503640,17820,3.4
Montana,2016,Oct,520764,501634,19130,3.7
Montana,2016,Nov,519905,500123,19782,3.8
Montana,2016,Dec,518649,496453,22196,4.3
Montana,2017,Jan,518174,492130,26044,5
Montana,2017,Feb,518740,494373,24367,4.7
Montana,2017,Mar,521194,497188,24006,4.6
Montana,2017,Apr,522742,502827,19915,3.8
Montana,2017,May,525320,507259,18061,3.4
Montana,2017,Jun,532513,511708,20805,3.9
Montana,2017,Jul,535048,515871,19177,3.6
Montana,2017,Aug,532319,513689,18630,3.5
Montana,2017,Sep,524956,507343,17613,3.4
Montana,2017,Oct,523961,505497,18464,3.5
Montana,2017,Nov,522873,502659,20214,3.9
Montana,2017,Dec,521135,500496,20639,4
Montana,2018,Jan,521320,496387,24933,4.8
Montana,2018,Feb,522485,498658,23827,4.6
Montana,2018,Mar,523623,500531,23092,4.4
Montana,2018,Apr,524335,505457,18878,3.6
Montana,2018,May,527631,511316,16315,3.1
Montana,2018,Jun,535803,516227,19576,3.7
Montana,2018,Jul,538836,520879,17957,3.3
Montana,2018,Aug,535854,518428,17426,3.3
Montana,2018,Sep,528163,511551,16612,3.1
Montana,2018,Oct,528418,510634,17784,3.4
Montana,2018,Nov,527399,508419,18980,3.6
Montana,2018,Dec,525061,504565,20496,3.9
Montana,2019,Jan,526192,500040,26152,5
Montana,2019,Feb,526362,503145,23217,4.4
Montana,2019,Mar,526999,505109,21890,4.2
Montana,2019,Apr,527648,510252,17396,3.3
Montana,2019,May,530896,516015,14881,2.8
Montana,2019,Jun,540568,523312,17256,3.2
Montana,2019,Jul,544367,529387,14980,2.8
Montana,2019,Aug,540798,524899,15899,2.9
Montana,2019,Sep,531565,515809,15756,3
Montana,2019,Oct,534388,517708,16680,3.1
Nebraska,2016,Jan,998375,964947,33428,3.3
Nebraska,2016,Feb,1003461,970610,32851,3.3
Nebraska,2016,Mar,1007314,974599,32715,3.2
Nebraska,2016,Apr,1010133,980105,30028,3
Nebraska,2016,May,1012628,983608,29020,2.9
Nebraska,2016,Jun,1021967,987939,34028,3.3
Nebraska,2016,Jul,1025516,991311,34205,3.3
Nebraska,2016,Aug,1012891,981522,31369,3.1
Nebraska,2016,Sep,1002455,973379,29076,2.9
Nebraska,2016,Oct,1009276,980646,28630,2.8
Nebraska,2016,Nov,1006139,980164,25975,2.6
Nebraska,2016,Dec,1003157,973568,29589,2.9
Nebraska,2017,Jan,998223,964044,34179,3.4
Nebraska,2017,Feb,1003350,970997,32353,3.2
Nebraska,2017,Mar,1005694,975357,30337,3
Nebraska,2017,Apr,1010852,981977,28875,2.9
Nebraska,2017,May,1013449,985540,27909,2.8
Nebraska,2017,Jun,1023314,991883,31431,3.1
Nebraska,2017,Jul,1027687,995653,32034,3.1
Nebraska,2017,Aug,1015848,986601,29247,2.9
Nebraska,2017,Sep,1006011,979219,26792,2.7
Nebraska,2017,Oct,1012543,987233,25310,2.5
Nebraska,2017,Nov,1012494,987992,24502,2.4
Nebraska,2017,Dec,1010041,982803,27238,2.7
Nebraska,2018,Jan,1004697,972401,32296,3.2
Nebraska,2018,Feb,1011707,979897,31810,3.1
Nebraska,2018,Mar,1014563,983570,30993,3.1
Nebraska,2018,Apr,1018547,990355,28192,2.8
Nebraska,2018,May,1022657,995828,26829,2.6
Nebraska,2018,Jun,1033056,1001932,31124,3
Nebraska,2018,Jul,1037738,1006245,31493,3
Nebraska,2018,Aug,1023665,996127,27538,2.7
Nebraska,2018,Sep,1013831,988593,25238,2.5
Nebraska,2018,Oct,1022354,996603,25751,2.5
Nebraska,2018,Nov,1020931,997473,23458,2.3
Nebraska,2018,Dec,1018612,991231,27381,2.7
Nebraska,2019,Jan,1021843,990003,31840,3.1
Nebraska,2019,Feb,1026761,994834,31927,3.1
Nebraska,2019,Mar,1031710,998212,33498,3.2
Nebraska,2019,Apr,1035655,1005349,30306,2.9
Nebraska,2019,May,1041239,1010000,31239,3
Nebraska,2019,Jun,1051621,1016191,35430,3.4
Nebraska,2019,Jul,1056715,1021567,35148,3.3
Nebraska,2019,Aug,1043554,1011551,32003,3.1
Nebraska,2019,Sep,1036023,1006502,29521,2.8
Nebraska,2019,Oct,1045946,1015405,30541,2.9
Nevada,2016,Jan,1410333,1318270,92063,6.5
Nevada,2016,Feb,1416434,1329379,87055,6.1
Nevada,2016,Mar,1416305,1330131,86174,6.1
Nevada,2016,Apr,1416102,1333320,82782,5.8
Nevada,2016,May,1419698,1339323,80375,5.7
Nevada,2016,Jun,1423810,1339431,84379,5.9
Nevada,2016,Jul,1431533,1347780,83753,5.9
Nevada,2016,Aug,1427261,1347436,79825,5.6
Nevada,2016,Sep,1431453,1352168,79285,5.5
Nevada,2016,Oct,1432706,1356174,76532,5.3
Nevada,2016,Nov,1433973,1359529,74444,5.2
Nevada,2016,Dec,1430134,1356733,73401,5.1
Nevada,2017,Jan,1433769,1353220,80549,5.6
Nevada,2017,Feb,1444263,1367356,76907,5.3
Nevada,2017,Mar,1446311,1371392,74919,5.2
Nevada,2017,Apr,1446931,1372595,74336,5.1
Nevada,2017,May,1452819,1380615,72204,5
Nevada,2017,Jun,1460031,1383381,76650,5.2
Nevada,2017,Jul,1467066,1391230,75836,5.2
Nevada,2017,Aug,1463414,1390217,73197,5
Nevada,2017,Sep,1469550,1397230,72320,4.9
Nevada,2017,Oct,1469875,1400632,69243,4.7
Nevada,2017,Nov,1473761,1404486,69275,4.7
Nevada,2017,Dec,1472334,1402907,69427,4.7
Nevada,2018,Jan,1473612,1397999,75613,5.1
Nevada,2018,Feb,1485731,1413854,71877,4.8
Nevada,2018,Mar,1485939,1415526,70413,4.7
Nevada,2018,Apr,1486528,1419037,67491,4.5
Nevada,2018,May,1493574,1428233,65341,4.4
Nevada,2018,Jun,1500499,1429790,70709,4.7
Nevada,2018,Jul,1508509,1438061,70448,4.7
Nevada,2018,Aug,1505454,1437576,67878,4.5
Nevada,2018,Sep,1511305,1443697,67608,4.5
Nevada,2018,Oct,1516177,1451513,64664,4.3
Nevada,2018,Nov,1518855,1454814,64041,4.2
Nevada,2018,Dec,1518338,1453410,64928,4.3
Nevada,2019,Jan,1517870,1447854,70016,4.6
Nevada,2019,Feb,1524643,1461449,63194,4.1
Nevada,2019,Mar,1516791,1460972,55819,3.7
Nevada,2019,Apr,1521065,1466064,55001,3.6
Nevada,2019,May,1534946,1476002,58944,3.8
Nevada,2019,Jun,1544514,1475178,69336,4.5
Nevada,2019,Jul,1552332,1482912,69420,4.5
Nevada,2019,Aug,1551881,1486557,65324,4.2
Nevada,2019,Sep,1558504,1499308,59196,3.8
Nevada,2019,Oct,1567125,1508630,58495,3.7
New Hampshire,2016,Jan,745796,720584,25212,3.4
New Hampshire,2016,Feb,747684,722518,25166,3.4
New Hampshire,2016,Mar,749651,725101,24550,3.3
New Hampshire,2016,Apr,745934,724812,21122,2.8
New Hampshire,2016,May,746945,726585,20360,2.7
New Hampshire,2016,Jun,758593,737094,21499,2.8
New Hampshire,2016,Jul,765011,743229,21782,2.8
New Hampshire,2016,Aug,760447,739237,21210,2.8
New Hampshire,2016,Sep,749770,730393,19377,2.6
New Hampshire,2016,Oct,748279,730106,18173,2.4
New Hampshire,2016,Nov,749521,730017,19504,2.6
New Hampshire,2016,Dec,748142,729023,19119,2.6
New Hampshire,2017,Jan,750138,725222,24916,3.3
New Hampshire,2017,Feb,750100,725007,25093,3.3
New Hampshire,2017,Mar,753013,729083,23930,3.2
New Hampshire,2017,Apr,748331,728323,20008,2.7
New Hampshire,2017,May,749920,730680,19240,2.6
New Hampshire,2017,Jun,762376,742409,19967,2.6
New Hampshire,2017,Jul,767740,747564,20176,2.6
New Hampshire,2017,Aug,763303,743195,20108,2.6
New Hampshire,2017,Sep,752090,733558,18532,2.5
New Hampshire,2017,Oct,751172,733901,17271,2.3
New Hampshire,2017,Nov,752620,734070,18550,2.5
New Hampshire,2017,Dec,752777,734809,17968,2.4
New Hampshire,2018,Jan,755437,731548,23889,3.2
New Hampshire,2018,Feb,757660,733535,24125,3.2
New Hampshire,2018,Mar,759912,736549,23363,3.1
New Hampshire,2018,Apr,754612,734947,19665,2.6
New Hampshire,2018,May,757689,739097,18592,2.5
New Hampshire,2018,Jun,770590,751122,19468,2.5
New Hampshire,2018,Jul,775808,756538,19270,2.5
New Hampshire,2018,Aug,770239,751700,18539,2.4
New Hampshire,2018,Sep,757972,741618,16354,2.2
New Hampshire,2018,Oct,759725,744534,15191,2
New Hampshire,2018,Nov,761578,745129,16449,2.2
New Hampshire,2018,Dec,759790,743821,15969,2.1
New Hampshire,2019,Jan,765064,742881,22183,2.9
New Hampshire,2019,Feb,766263,744088,22175,2.9
New Hampshire,2019,Mar,766652,744858,21794,2.8
New Hampshire,2019,Apr,763783,744872,18911,2.5
New Hampshire,2019,May,766557,748054,18503,2.4
New Hampshire,2019,Jun,779924,761123,18801,2.4
New Hampshire,2019,Jul,786099,766812,19287,2.5
New Hampshire,2019,Aug,781778,762025,19753,2.5
New Hampshire,2019,Sep,770546,752453,18093,2.3
New Hampshire,2019,Oct,774283,756370,17913,2.3
New Jersey,2016,Jan,4440624,4208724,231900,5.2
New Jersey,2016,Feb,4474232,4233633,240599,5.4
New Jersey,2016,Mar,4483631,4242875,240756,5.4
New Jersey,2016,Apr,4466997,4246671,220326,4.9
New Jersey,2016,May,4471230,4251181,220049,4.9
New Jersey,2016,Jun,4518260,4285135,233125,5.2
New Jersey,2016,Jul,4543276,4293133,250143,5.5
New Jersey,2016,Aug,4500035,4268527,231508,5.1
New Jersey,2016,Sep,4451047,4230805,220242,4.9
New Jersey,2016,Oct,4460350,4253414,206936,4.6
New Jersey,2016,Nov,4443094,4256102,186992,4.2
New Jersey,2016,Dec,4443493,4254540,188953,4.3
New Jersey,2017,Jan,4430366,4208321,222045,5
New Jersey,2017,Feb,4456642,4232585,224057,5
New Jersey,2017,Mar,4453574,4249081,204493,4.6
New Jersey,2017,Apr,4447016,4257265,189751,4.3
New Jersey,2017,May,4450316,4253941,196375,4.4
New Jersey,2017,Jun,4501955,4294980,206975,4.6
New Jersey,2017,Jul,4523393,4291329,232064,5.1
New Jersey,2017,Aug,4480439,4256772,223667,5
New Jersey,2017,Sep,4435312,4228483,206829,4.7
New Jersey,2017,Oct,4429013,4235687,193326,4.4
New Jersey,2017,Nov,4422044,4232380,189664,4.3
New Jersey,2017,Dec,4412231,4229598,182633,4.1
New Jersey,2018,Jan,4392534,4174549,217985,5
New Jersey,2018,Feb,4429034,4209751,219283,5
New Jersey,2018,Mar,4413614,4210872,202742,4.6
New Jersey,2018,Apr,4398322,4223424,174898,4
New Jersey,2018,May,4409315,4238084,171231,3.9
New Jersey,2018,Jun,4476647,4279899,196748,4.4
New Jersey,2018,Jul,4495703,4287286,208417,4.6
New Jersey,2018,Aug,4432697,4246668,186029,4.2
New Jersey,2018,Sep,4383803,4218915,164888,3.8
New Jersey,2018,Oct,4412319,4258129,154190,3.5
New Jersey,2018,Nov,4409867,4264090,145777,3.3
New Jersey,2018,Dec,4421437,4263131,158306,3.6
New Jersey,2019,Jan,4429139,4226152,202987,4.6
New Jersey,2019,Feb,4458265,4250763,207502,4.7
New Jersey,2019,Mar,4450721,4268472,182249,4.1
New Jersey,2019,Apr,4401625,4272445,129180,2.9
New Jersey,2019,May,4424044,4291959,132085,3
New Jersey,2019,Jun,4481379,4347761,133618,3
New Jersey,2019,Jul,4537085,4379482,157603,3.5
New Jersey,2019,Aug,4526095,4370560,155535,3.4
New Jersey,2019,Sep,4507912,4363215,144697,3.2
New Jersey,2019,Oct,4557721,4407966,149755,3.3
New Mexico,2016,Jan,930841,868443,62398,6.7
New Mexico,2016,Feb,935701,874061,61640,6.6
New Mexico,2016,Mar,932835,872139,60696,6.5
New Mexico,2016,Apr,931854,874384,57470,6.2
New Mexico,2016,May,931087,872947,58140,6.2
New Mexico,2016,Jun,940913,871307,69606,7.4
New Mexico,2016,Jul,939676,870769,68907,7.3
New Mexico,2016,Aug,935935,871080,64855,6.9
New Mexico,2016,Sep,935411,873379,62032,6.6
New Mexico,2016,Oct,938822,878377,60445,6.4
New Mexico,2016,Nov,941759,882298,59461,6.3
New Mexico,2016,Dec,941338,883900,57438,6.1
New Mexico,2017,Jan,931686,869963,61723,6.6
New Mexico,2017,Feb,934960,875053,59907,6.4
New Mexico,2017,Mar,933509,876415,57094,6.1
New Mexico,2017,Apr,932900,880580,52320,5.6
New Mexico,2017,May,930110,878128,51982,5.6
New Mexico,2017,Jun,941849,880297,61552,6.5
New Mexico,2017,Jul,939847,879946,59901,6.4
New Mexico,2017,Aug,934577,878844,55733,6
New Mexico,2017,Sep,936552,883884,52668,5.6
New Mexico,2017,Oct,937798,887566,50232,5.4
New Mexico,2017,Nov,941000,891513,49487,5.3
New Mexico,2017,Dec,940058,892832,47226,5
New Mexico,2018,Jan,931015,880635,50380,5.4
New Mexico,2018,Feb,935763,887874,47889,5.1
New Mexico,2018,Mar,932495,887579,44916,4.8
New Mexico,2018,Apr,931907,890623,41284,4.4
New Mexico,2018,May,931111,890467,40644,4.4
New Mexico,2018,Jun,944787,893286,51501,5.5
New Mexico,2018,Jul,944247,893810,50437,5.3
New Mexico,2018,Aug,937988,890968,47020,5
New Mexico,2018,Sep,939873,893834,46039,4.9
New Mexico,2018,Oct,948513,902331,46182,4.9
New Mexico,2018,Nov,952647,906635,46012,4.8
New Mexico,2018,Dec,953970,907837,46133,4.8
New Mexico,2019,Jan,955595,902784,52811,5.5
New Mexico,2019,Feb,958186,908452,49734,5.2
New Mexico,2019,Mar,950027,906357,43670,4.6
New Mexico,2019,Apr,950452,909347,41105,4.3
New Mexico,2019,May,954000,911238,42762,4.5
New Mexico,2019,Jun,970505,917065,53440,5.5
New Mexico,2019,Jul,972884,918000,54884,5.6
New Mexico,2019,Aug,964708,915919,48789,5.1
New Mexico,2019,Sep,963823,920120,43703,4.5
New Mexico,2019,Oct,967324,923354,43970,4.5
New York,2016,Jan,9555107,9050364,504743,5.3
New York,2016,Feb,9593770,9086628,507142,5.3
New York,2016,Mar,9604039,9119258,484781,5
New York,2016,Apr,9532466,9094716,437750,4.6
New York,2016,May,9525164,9114824,410340,4.3
New York,2016,Jun,9616964,9161800,455164,4.7
New York,2016,Jul,9664503,9174606,489897,5.1
New York,2016,Aug,9598709,9116191,482518,5
New York,2016,Sep,9538056,9067585,470471,4.9
New York,2016,Oct,9538171,9078644,459527,4.8
New York,2016,Nov,9474939,9046691,428248,4.5
New York,2016,Dec,9443233,9011540,431693,4.6
New York,2017,Jan,9492341,8993138,499203,5.3
New York,2017,Feb,9542875,9038825,504050,5.3
New York,2017,Mar,9569624,9121367,448257,4.7
New York,2017,Apr,9549683,9132780,416903,4.4
New York,2017,May,9547005,9124930,422075,4.4
New York,2017,Jun,9649660,9204852,444808,4.6
New York,2017,Jul,9706379,9227575,478804,4.9
New York,2017,Aug,9619885,9143468,476417,5
New York,2017,Sep,9594185,9157209,436976,4.6
New York,2017,Oct,9536073,9118331,417742,4.4
New York,2017,Nov,9485139,9070351,414788,4.4
New York,2017,Dec,9443956,9030390,413566,4.4
New York,2018,Jan,9466302,8988723,477579,5
New York,2018,Feb,9562886,9078297,484589,5.1
New York,2018,Mar,9554320,9118084,436236,4.6
New York,2018,Apr,9514505,9130901,383604,4
New York,2018,May,9536204,9186121,350083,3.7
New York,2018,Jun,9660027,9263121,396906,4.1
New York,2018,Jul,9712136,9308984,403152,4.2
New York,2018,Aug,9579389,9193598,385791,4
New York,2018,Sep,9547754,9200191,347563,3.6
New York,2018,Oct,9603222,9255770,347452,3.6
New York,2018,Nov,9576358,9236941,339417,3.5
New York,2018,Dec,9583357,9211959,371398,3.9
New York,2019,Jan,9571736,9132711,439025,4.6
New York,2019,Feb,9556617,9137766,418851,4.4
New York,2019,Mar,9591302,9197882,393420,4.1
New York,2019,Apr,9542495,9203203,339292,3.6
New York,2019,May,9541725,9181064,360661,3.8
New York,2019,Jun,9563221,9202851,360370,3.8
New York,2019,Jul,9579695,9183933,395762,4.1
New York,2019,Aug,9537116,9139138,397978,4.2
New York,2019,Sep,9539775,9186605,353170,3.7
New York,2019,Oct,9583705,9210431,373274,3.9
North Carolina,2016,Jan,4781088,4519984,261104,5.5
North Carolina,2016,Feb,4819473,4564143,255330,5.3
North Carolina,2016,Mar,4851451,4604430,247021,5.1
North Carolina,2016,Apr,4839597,4609392,230205,4.8
North Carolina,2016,May,4857645,4626211,231434,4.8
North Carolina,2016,Jun,4869286,4614574,254712,5.2
North Carolina,2016,Jul,4896475,4636018,260457,5.3
North Carolina,2016,Aug,4853337,4597954,255383,5.3
North Carolina,2016,Sep,4888901,4646006,242895,5
North Carolina,2016,Oct,4911190,4660434,250756,5.1
North Carolina,2016,Nov,4893673,4653062,240611,4.9
North Carolina,2016,Dec,4860987,4627389,233598,4.8
North Carolina,2017,Jan,4870765,4616324,254441,5.2
North Carolina,2017,Feb,4907966,4663223,244743,5
North Carolina,2017,Mar,4931604,4709814,221790,4.5
North Carolina,2017,Apr,4923239,4720833,202406,4.1
North Carolina,2017,May,4937994,4725588,212406,4.3
North Carolina,2017,Jun,4949452,4726622,222830,4.5
North Carolina,2017,Jul,4983567,4748953,234614,4.7
North Carolina,2017,Aug,4935168,4701556,233612,4.7
North Carolina,2017,Sep,4983754,4778690,205064,4.1
North Carolina,2017,Oct,4967289,4763404,203885,4.1
North Carolina,2017,Nov,4954741,4741577,213164,4.3
North Carolina,2017,Dec,4911325,4710124,201201,4.1
North Carolina,2018,Jan,4908404,4690541,217863,4.4
North Carolina,2018,Feb,4974728,4756870,217858,4.4
North Carolina,2018,Mar,4987008,4785923,201085,4
North Carolina,2018,Apr,4975010,4794773,180237,3.6
North Carolina,2018,May,5004225,4821167,183058,3.7
North Carolina,2018,Jun,5016188,4806832,209356,4.2
North Carolina,2018,Jul,5035639,4828216,207423,4.1
North Carolina,2018,Aug,4949551,4750792,198759,4
North Carolina,2018,Sep,4965574,4793543,172031,3.5
North Carolina,2018,Oct,5007407,4826318,181089,3.6
North Carolina,2018,Nov,4992016,4811766,180250,3.6
North Carolina,2018,Dec,4966260,4781104,185156,3.7
North Carolina,2019,Jan,4992100,4766577,225523,4.5
North Carolina,2019,Feb,5035556,4824256,211300,4.2
North Carolina,2019,Mar,5065791,4859333,206458,4.1
North Carolina,2019,Apr,5066547,4886550,179997,3.6
North Carolina,2019,May,5121254,4915410,205844,4
North Carolina,2019,Jun,5149413,4920288,229125,4.4
North Carolina,2019,Jul,5178997,4952156,226841,4.4
North Carolina,2019,Aug,5106654,4885906,220748,4.3
North Carolina,2019,Sep,5122133,4943765,178368,3.5
North Carolina,2019,Oct,5153426,4968201,185225,3.6
North Dakota,2016,Jan,406363,390291,16072,4
North Dakota,2016,Feb,407934,391572,16362,4
North Dakota,2016,Mar,409379,392780,16599,4.1
North Dakota,2016,Apr,410824,397060,13764,3.4
North Dakota,2016,May,414152,402188,11964,2.9
North Dakota,2016,Jun,421829,407404,14425,3.4
North Dakota,2016,Jul,421616,409469,12147,2.9
North Dakota,2016,Aug,420289,408390,11899,2.8
North Dakota,2016,Sep,413245,403705,9540,2.3
North Dakota,2016,Oct,412385,403808,8577,2.1
North Dakota,2016,Nov,408307,398332,9975,2.4
North Dakota,2016,Dec,406852,394954,11898,2.9
North Dakota,2017,Jan,406464,391688,14776,3.6
North Dakota,2017,Feb,407792,393444,14348,3.5
North Dakota,2017,Mar,408757,395046,13711,3.4
North Dakota,2017,Apr,410075,399126,10949,2.7
North Dakota,2017,May,412504,403407,9097,2.2
North Dakota,2017,Jun,420125,408244,11881,2.8
North Dakota,2017,Jul,418744,408811,9933,2.4
North Dakota,2017,Aug,416548,406386,10162,2.4
North Dakota,2017,Sep,409594,401178,8416,2.1
North Dakota,2017,Oct,408148,400510,7638,1.9
North Dakota,2017,Nov,403877,394328,9549,2.4
North Dakota,2017,Dec,402122,391218,10904,2.7
North Dakota,2018,Jan,401007,387161,13846,3.5
North Dakota,2018,Feb,402071,388342,13729,3.4
North Dakota,2018,Mar,402467,388894,13573,3.4
North Dakota,2018,Apr,403296,391568,11728,2.9
North Dakota,2018,May,405962,396758,9204,2.3
North Dakota,2018,Jun,413423,401632,11791,2.9
North Dakota,2018,Jul,412149,402336,9813,2.4
North Dakota,2018,Aug,409703,399921,9782,2.4
North Dakota,2018,Sep,403172,395152,8020,2
North Dakota,2018,Oct,402879,395722,7157,1.8
North Dakota,2018,Nov,398404,390056,8348,2.1
North Dakota,2018,Dec,397048,387516,9532,2.4
North Dakota,2019,Jan,399506,387504,12002,3
North Dakota,2019,Feb,403007,390981,12026,3
North Dakota,2019,Mar,403356,391282,12074,3
North Dakota,2019,Apr,403516,393381,10135,2.5
North Dakota,2019,May,405781,397302,8479,2.1
North Dakota,2019,Jun,412607,401613,10994,2.7
North Dakota,2019,Jul,411362,402063,9299,2.3
North Dakota,2019,Aug,409346,400317,9029,2.2
North Dakota,2019,Sep,403489,395660,7829,1.9
North Dakota,2019,Oct,404174,397216,6958,1.7
Ohio,2016,Jan,5659090,5343122,315968,5.6
Ohio,2016,Feb,5701960,5388479,313481,5.5
Ohio,2016,Mar,5733650,5427905,305745,5.3
Ohio,2016,Apr,5731279,5455694,275585,4.8
Ohio,2016,May,5736773,5483610,253163,4.4
Ohio,2016,Jun,5778455,5484204,294251,5.1
Ohio,2016,Jul,5796536,5505716,290820,5
Ohio,2016,Aug,5772238,5486358,285880,5
Ohio,2016,Sep,5743877,5455324,288553,5
Ohio,2016,Oct,5759096,5477940,281156,4.9
Ohio,2016,Nov,5742839,5472885,269954,4.7
Ohio,2016,Dec,5712372,5426231,286141,5
Ohio,2017,Jan,5700407,5354586,345821,6.1
Ohio,2017,Feb,5736725,5401465,335260,5.8
Ohio,2017,Mar,5754212,5451768,302444,5.3
Ohio,2017,Apr,5753325,5486998,266327,4.6
Ohio,2017,May,5767517,5501026,266491,4.6
Ohio,2017,Jun,5825625,5521597,304028,5.2
Ohio,2017,Jul,5847947,5539257,308690,5.3
Ohio,2017,Aug,5814583,5517147,297436,5.1
Ohio,2017,Sep,5786260,5516315,269945,4.7
Ohio,2017,Oct,5775970,5525250,250720,4.3
Ohio,2017,Nov,5763702,5516523,247179,4.3
Ohio,2017,Dec,5715873,5465753,250120,4.4
Ohio,2018,Jan,5669900,5375750,294150,5.2
Ohio,2018,Feb,5732276,5444157,288119,5
Ohio,2018,Mar,5739578,5470283,269295,4.7
Ohio,2018,Apr,5738955,5494027,244928,4.3
Ohio,2018,May,5761621,5524419,237202,4.1
Ohio,2018,Jun,5825104,5533132,291972,5
Ohio,2018,Jul,5830734,5555155,275579,4.7
Ohio,2018,Aug,5762009,5507050,254959,4.4
Ohio,2018,Sep,5730788,5491968,238820,4.2
Ohio,2018,Oct,5774153,5527157,246996,4.3
Ohio,2018,Nov,5754616,5511308,243308,4.2
Ohio,2018,Dec,5739445,5464619,274826,4.8
Ohio,2019,Jan,5758116,5448870,309246,5.4
Ohio,2019,Feb,5788285,5518789,269496,4.7
Ohio,2019,Mar,5809996,5568996,241000,4.1
Ohio,2019,Apr,5794037,5601885,192152,3.3
Ohio,2019,May,5773062,5568828,204234,3.5
Ohio,2019,Jun,5869085,5619907,249178,4.2
Ohio,2019,Jul,5924591,5652153,272438,4.6
Ohio,2019,Aug,5879181,5630934,248247,4.2
Ohio,2019,Sep,5811297,5571021,240276,4.1
Ohio,2019,Oct,5826663,5598726,227937,3.9
Oklahoma,2016,Jan,1826137,1739646,86491,4.7
Oklahoma,2016,Feb,1833717,1744380,89337,4.9
Oklahoma,2016,Mar,1837420,1750058,87362,4.8
Oklahoma,2016,Apr,1827700,1745372,82328,4.5
Oklahoma,2016,May,1828270,1738986,89284,4.9
Oklahoma,2016,Jun,1842814,1745125,97689,5.3
Oklahoma,2016,Jul,1835298,1742112,93186,5.1
Oklahoma,2016,Aug,1826485,1734613,91872,5
Oklahoma,2016,Sep,1830927,1742462,88465,4.8
Oklahoma,2016,Oct,1835397,1748033,87364,4.8
Oklahoma,2016,Nov,1837534,1754911,82623,4.5
Oklahoma,2016,Dec,1822363,1740094,82269,4.5
Oklahoma,2017,Jan,1816103,1728706,87397,4.8
Oklahoma,2017,Feb,1822022,1735794,86228,4.7
Oklahoma,2017,Mar,1829690,1749934,79756,4.4
Oklahoma,2017,Apr,1825572,1752971,72601,4
Oklahoma,2017,May,1829062,1749052,80010,4.4
Oklahoma,2017,Jun,1849768,1764794,84974,4.6
Oklahoma,2017,Jul,1843775,1764692,79083,4.3
Oklahoma,2017,Aug,1834743,1756628,78115,4.3
Oklahoma,2017,Sep,1848083,1774466,73617,4
Oklahoma,2017,Oct,1847508,1775149,72359,3.9
Oklahoma,2017,Nov,1850671,1780613,70058,3.8
Oklahoma,2017,Dec,1838324,1768189,70135,3.8
Oklahoma,2018,Jan,1833934,1758372,75562,4.1
Oklahoma,2018,Feb,1844674,1770675,73999,4
Oklahoma,2018,Mar,1847864,1779668,68196,3.7
Oklahoma,2018,Apr,1839219,1778337,60882,3.3
Oklahoma,2018,May,1843360,1778975,64385,3.5
Oklahoma,2018,Jun,1858945,1789748,69197,3.7
Oklahoma,2018,Jul,1849373,1787941,61432,3.3
Oklahoma,2018,Aug,1828471,1770760,57711,3.2
Oklahoma,2018,Sep,1834606,1780763,53843,2.9
Oklahoma,2018,Oct,1844742,1788400,56342,3.1
Oklahoma,2018,Nov,1845292,1792102,53190,2.9
Oklahoma,2018,Dec,1831981,1776693,55288,3
Oklahoma,2019,Jan,1812217,1743865,68352,3.8
Oklahoma,2019,Feb,1823176,1759147,64029,3.5
Oklahoma,2019,Mar,1824859,1765753,59106,3.2
Oklahoma,2019,Apr,1816608,1766420,50188,2.8
Oklahoma,2019,May,1831522,1774537,56985,3.1
Oklahoma,2019,Jun,1858722,1794813,63909,3.4
Oklahoma,2019,Jul,1867797,1804157,63640,3.4
Oklahoma,2019,Aug,1855215,1793301,61914,3.3
Oklahoma,2019,Sep,1857552,1799581,57971,3.1
Oklahoma,2019,Oct,1856199,1794255,61944,3.3
Oregon,2016,Jan,2000405,1890226,110179,5.5
Oregon,2016,Feb,2018679,1907941,110738,5.5
Oregon,2016,Mar,2029690,1919194,110496,5.4
Oregon,2016,Apr,2032712,1932009,100703,5
Oregon,2016,May,2036398,1943050,93348,4.6
Oregon,2016,Jun,2062657,1957347,105310,5.1
Oregon,2016,Jul,2073976,1967682,106294,5.1
Oregon,2016,Aug,2074295,1973337,100958,4.9
Oregon,2016,Sep,2067231,1978113,89118,4.3
Oregon,2016,Oct,2068213,1980342,87871,4.2
Oregon,2016,Nov,2066889,1982741,84148,4.1
Oregon,2016,Dec,2049098,1967154,81944,4
Oregon,2017,Jan,2046244,1949726,96518,4.7
Oregon,2017,Feb,2063591,1968709,94882,4.6
Oregon,2017,Mar,2073204,1979859,93345,4.5
Oregon,2017,Apr,2080233,1998249,81984,3.9
Oregon,2017,May,2081124,2003845,77279,3.7
Oregon,2017,Jun,2106352,2018025,88327,4.2
Oregon,2017,Jul,2120422,2028315,92107,4.3
Oregon,2017,Aug,2116466,2025560,90906,4.3
Oregon,2017,Sep,2111548,2032710,78838,3.7
Oregon,2017,Oct,2103115,2024582,78533,3.7
Oregon,2017,Nov,2101180,2021589,79591,3.8
Oregon,2017,Dec,2084397,2003792,80605,3.9
Oregon,2018,Jan,2081656,1984282,97374,4.7
Oregon,2018,Feb,2094704,1997550,97154,4.6
Oregon,2018,Mar,2092084,1997568,94516,4.5
Oregon,2018,Apr,2089666,2006665,83001,4
Oregon,2018,May,2090640,2015864,74776,3.6
Oregon,2018,Jun,2112449,2024528,87921,4.2
Oregon,2018,Jul,2125001,2035626,89375,4.2
Oregon,2018,Aug,2115832,2028164,87668,4.1
Oregon,2018,Sep,2112722,2034922,77800,3.7
Oregon,2018,Oct,2117663,2034234,83429,3.9
Oregon,2018,Nov,2117387,2031656,85731,4
Oregon,2018,Dec,2104382,2014797,89585,4.3
Oregon,2019,Jan,2103009,1998836,104173,5
Oregon,2019,Feb,2115245,2016407,98838,4.7
Oregon,2019,Mar,2113625,2016400,97225,4.6
Oregon,2019,Apr,2106615,2023964,82651,3.9
Oregon,2019,May,2105751,2036289,69462,3.3
Oregon,2019,Jun,2118160,2034327,83833,4
Oregon,2019,Jul,2135807,2046153,89654,4.2
Oregon,2019,Aug,2139838,2045304,94534,4.4
Oregon,2019,Sep,2124764,2042144,82620,3.9
Oregon,2019,Oct,2119417,2044941,74476,3.5
Pennsylvania,2016,Jan,6404663,6048568,356095,5.6
Pennsylvania,2016,Feb,6428019,6062493,365526,5.7
Pennsylvania,2016,Mar,6442021,6080785,361236,5.6
Pennsylvania,2016,Apr,6434768,6103197,331571,5.2
Pennsylvania,2016,May,6454547,6120058,334489,5.2
Pennsylvania,2016,Jun,6507248,6137719,369529,5.7
Pennsylvania,2016,Jul,6549594,6163215,386379,5.9
Pennsylvania,2016,Aug,6488884,6111844,377040,5.8
Pennsylvania,2016,Sep,6451024,6111164,339860,5.3
Pennsylvania,2016,Oct,6439790,6108335,331455,5.1
Pennsylvania,2016,Nov,6419562,6113397,306165,4.8
Pennsylvania,2016,Dec,6380510,6075308,305202,4.8
Pennsylvania,2017,Jan,6399593,6037767,361826,5.7
Pennsylvania,2017,Feb,6420156,6058745,361411,5.6
Pennsylvania,2017,Mar,6420390,6088868,331522,5.2
Pennsylvania,2017,Apr,6423614,6131613,292001,4.5
Pennsylvania,2017,May,6430814,6126868,303946,4.7
Pennsylvania,2017,Jun,6480724,6153049,327675,5.1
Pennsylvania,2017,Jul,6515790,6174374,341416,5.2
Pennsylvania,2017,Aug,6450317,6112093,338224,5.2
Pennsylvania,2017,Sep,6423434,6138494,284940,4.4
Pennsylvania,2017,Oct,6385071,6110822,274249,4.3
Pennsylvania,2017,Nov,6392129,6114325,277804,4.3
Pennsylvania,2017,Dec,6353480,6079628,273852,4.3
Pennsylvania,2018,Jan,6351938,6032295,319643,5
Pennsylvania,2018,Feb,6398071,6078166,319905,5
Pennsylvania,2018,Mar,6376939,6088343,288596,4.5
Pennsylvania,2018,Apr,6378250,6125594,252656,4
Pennsylvania,2018,May,6403511,6154712,248799,3.9
Pennsylvania,2018,Jun,6484141,6184900,299241,4.6
Pennsylvania,2018,Jul,6530022,6223945,306077,4.7
Pennsylvania,2018,Aug,6443881,6148402,295479,4.6
Pennsylvania,2018,Sep,6414056,6164812,249244,3.9
Pennsylvania,2018,Oct,6444551,6196535,248016,3.8
Pennsylvania,2018,Nov,6437401,6203624,233777,3.6
Pennsylvania,2018,Dec,6430281,6182288,247993,3.9
Pennsylvania,2019,Jan,6429180,6156080,273100,4.2
Pennsylvania,2019,Feb,6461939,6190973,270966,4.2
Pennsylvania,2019,Mar,6452006,6201071,250935,3.9
Pennsylvania,2019,Apr,6421347,6215423,205924,3.2
Pennsylvania,2019,May,6468559,6225772,242787,3.8
Pennsylvania,2019,Jun,6524148,6261325,262823,4
Pennsylvania,2019,Jul,6576635,6275113,301522,4.6
Pennsylvania,2019,Aug,6539968,6245184,294784,4.5
Pennsylvania,2019,Sep,6522663,6266705,255958,3.9
Pennsylvania,2019,Oct,6570222,6284395,285827,4.4
Rhode Island,2016,Jan,550565,515793,34772,6.3
Rhode Island,2016,Feb,550917,517197,33720,6.1
Rhode Island,2016,Mar,550388,518474,31914,5.8
Rhode Island,2016,Apr,548978,521294,27684,5
Rhode Island,2016,May,549454,521752,27702,5
Rhode Island,2016,Jun,556949,528872,28077,5
Rhode Island,2016,Jul,561123,530170,30953,5.5
Rhode Island,2016,Aug,558463,528900,29563,5.3
Rhode Island,2016,Sep,553810,527248,26562,4.8
Rhode Island,2016,Oct,553240,528361,24879,4.5
Rhode Island,2016,Nov,554961,529792,25169,4.5
Rhode Island,2016,Dec,552169,528574,23595,4.3
Rhode Island,2017,Jan,549957,519941,30016,5.5
Rhode Island,2017,Feb,549899,521515,28384,5.2
Rhode Island,2017,Mar,548707,522286,26421,4.8
Rhode Island,2017,Apr,547768,525700,22068,4
Rhode Island,2017,May,548755,526839,21916,4
Rhode Island,2017,Jun,556983,533959,23024,4.1
Rhode Island,2017,Jul,561146,535006,26140,4.7
Rhode Island,2017,Aug,558850,534153,24697,4.4
Rhode Island,2017,Sep,554597,532235,22362,4
Rhode Island,2017,Oct,554238,532360,21878,3.9
Rhode Island,2017,Nov,557851,534073,23778,4.3
Rhode Island,2017,Dec,555493,532953,22540,4.1
Rhode Island,2018,Jan,551949,522841,29108,5.3
Rhode Island,2018,Feb,553441,525576,27865,5
Rhode Island,2018,Mar,551741,526276,25465,4.6
Rhode Island,2018,Apr,550675,529665,21010,3.8
Rhode Island,2018,May,551828,531749,20079,3.6
Rhode Island,2018,Jun,558856,538297,20559,3.7
Rhode Island,2018,Jul,562798,539335,23463,4.2
Rhode Island,2018,Aug,560074,537661,22413,4
Rhode Island,2018,Sep,556243,536316,19927,3.6
Rhode Island,2018,Oct,556208,537026,19182,3.4
Rhode Island,2018,Nov,558933,537366,21567,3.9
Rhode Island,2018,Dec,556929,535941,20988,3.8
Rhode Island,2019,Jan,551697,524860,26837,4.9
Rhode Island,2019,Feb,549106,525343,23763,4.3
Rhode Island,2019,Mar,545702,525316,20386,3.7
Rhode Island,2019,Apr,545023,528651,16372,3
Rhode Island,2019,May,547439,529360,18079,3.3
Rhode Island,2019,Jun,557106,538795,18311,3.3
Rhode Island,2019,Jul,564696,543632,21064,3.7
Rhode Island,2019,Aug,562876,541165,21711,3.9
Rhode Island,2019,Sep,555580,537340,18240,3.3
Rhode Island,2019,Oct,558149,541944,16205,2.9
South Carolina,2016,Jan,2263669,2132841,130828,5.8
South Carolina,2016,Feb,2271062,2147639,123423,5.4
South Carolina,2016,Mar,2284064,2164904,119160,5.2
South Carolina,2016,Apr,2283862,2178788,105074,4.6
South Carolina,2016,May,2293846,2188099,105747,4.6
South Carolina,2016,Jun,2321845,2196418,125427,5.4
South Carolina,2016,Jul,2321427,2198405,123022,5.3
South Carolina,2016,Aug,2306319,2184568,121751,5.3
South Carolina,2016,Sep,2294577,2182805,111772,4.9
South Carolina,2016,Oct,2289724,2180688,109036,4.8
South Carolina,2016,Nov,2278154,2177729,100425,4.4
South Carolina,2016,Dec,2278197,2174128,104069,4.6
South Carolina,2017,Jan,2282718,2166929,115789,5.1
South Carolina,2017,Feb,2288043,2181482,106561,4.7
South Carolina,2017,Mar,2294186,2200385,93801,4.1
South Carolina,2017,Apr,2295433,2213573,81860,3.6
South Carolina,2017,May,2307206,2219324,87882,3.8
South Carolina,2017,Jun,2335121,2231711,103410,4.4
South Carolina,2017,Jul,2338427,2230809,107618,4.6
South Carolina,2017,Aug,2322958,2211707,111251,4.8
South Carolina,2017,Sep,2310663,2215021,95642,4.1
South Carolina,2017,Oct,2307359,2212016,95343,4.1
South Carolina,2017,Nov,2296376,2205633,90743,4
South Carolina,2017,Dec,2293769,2200263,93506,4.1
South Carolina,2018,Jan,2301213,2199604,101609,4.4
South Carolina,2018,Feb,2312220,2220310,91910,4
South Carolina,2018,Mar,2312170,2232515,79655,3.4
South Carolina,2018,Apr,2305243,2242968,62275,2.7
South Carolina,2018,May,2320482,2254775,65707,2.8
South Carolina,2018,Jun,2354320,2266726,87594,3.7
South Carolina,2018,Jul,2353384,2268794,84590,3.6
South Carolina,2018,Aug,2329822,2244437,85385,3.7
South Carolina,2018,Sep,2316250,2241226,75024,3.2
South Carolina,2018,Oct,2330794,2255421,75373,3.2
South Carolina,2018,Nov,2318289,2249850,68439,3
South Carolina,2018,Dec,2324318,2247240,77078,3.3
South Carolina,2019,Jan,2329764,2245388,84376,3.6
South Carolina,2019,Feb,2349066,2272304,76762,3.3
South Carolina,2019,Mar,2367678,2288668,79010,3.3
South Carolina,2019,Apr,2372742,2302525,70217,3
South Carolina,2019,May,2388261,2308617,79644,3.3
South Carolina,2019,Jun,2411214,2324679,86535,3.6
South Carolina,2019,Jul,2413600,2335669,77931,3.2
South Carolina,2019,Aug,2393115,2322886,70229,2.9
South Carolina,2019,Sep,2362736,2320277,42459,1.8
South Carolina,2019,Oct,2380158,2329972,50186,2.1
South Dakota,2016,Jan,444924,429987,14937,3.4
South Dakota,2016,Feb,447505,432156,15349,3.4
South Dakota,2016,Mar,449438,434974,14464,3.2
South Dakota,2016,Apr,450043,437109,12934,2.9
South Dakota,2016,May,452041,439749,12292,2.7
South Dakota,2016,Jun,460059,446553,13506,2.9
South Dakota,2016,Jul,461277,448651,12626,2.7
South Dakota,2016,Aug,457342,443850,13492,3
South Dakota,2016,Sep,451352,439225,12127,2.7
South Dakota,2016,Oct,454077,442017,12060,2.7
South Dakota,2016,Nov,453854,440722,13132,2.9
South Dakota,2016,Dec,451376,436518,14858,3.3
South Dakota,2017,Jan,448308,431854,16454,3.7
South Dakota,2017,Feb,450518,433836,16682,3.7
South Dakota,2017,Mar,452905,437074,15831,3.5
South Dakota,2017,Apr,454088,439836,14252,3.1
South Dakota,2017,May,455927,442276,13651,3
South Dakota,2017,Jun,463304,448825,14479,3.1
South Dakota,2017,Jul,463299,449546,13753,3
South Dakota,2017,Aug,460061,445427,14634,3.2
South Dakota,2017,Sep,454814,441756,13058,2.9
South Dakota,2017,Oct,457831,445016,12815,2.8
South Dakota,2017,Nov,457149,443164,13985,3.1
South Dakota,2017,Dec,455030,440037,14993,3.3
South Dakota,2018,Jan,451917,435644,16273,3.6
South Dakota,2018,Feb,454597,438139,16458,3.6
South Dakota,2018,Mar,456469,440660,15809,3.5
South Dakota,2018,Apr,455905,441084,14821,3.3
South Dakota,2018,May,458579,445744,12835,2.8
South Dakota,2018,Jun,466018,452417,13601,2.9
South Dakota,2018,Jul,466675,453998,12677,2.7
South Dakota,2018,Aug,462612,449405,13207,2.9
South Dakota,2018,Sep,457620,445644,11976,2.6
South Dakota,2018,Oct,461575,449510,12065,2.6
South Dakota,2018,Nov,461667,448918,12749,2.8
South Dakota,2018,Dec,459874,446025,13849,3
South Dakota,2019,Jan,459214,444197,15017,3.3
South Dakota,2019,Feb,461790,446645,15145,3.3
South Dakota,2019,Mar,463142,448619,14523,3.1
South Dakota,2019,Apr,462538,449100,13438,2.9
South Dakota,2019,May,464976,451960,13016,2.8
South Dakota,2019,Jun,474845,461056,13789,2.9
South Dakota,2019,Jul,475997,463166,12831,2.7
South Dakota,2019,Aug,471393,457489,13904,2.9
South Dakota,2019,Sep,467128,454334,12794,2.7
South Dakota,2019,Oct,470707,457320,13387,2.8
Tennessee,2016,Jan,3070213,2916143,154070,5
Tennessee,2016,Feb,3091937,2946754,145183,4.7
Tennessee,2016,Mar,3107243,2962381,144862,4.7
Tennessee,2016,Apr,3105212,2974163,131049,4.2
Tennessee,2016,May,3115080,2986272,128808,4.1
Tennessee,2016,Jun,3160044,2995723,164321,5.2
Tennessee,2016,Jul,3163976,3001099,162877,5.1
Tennessee,2016,Aug,3136910,2981495,155415,5
Tennessee,2016,Sep,3149010,2993825,155185,4.9
Tennessee,2016,Oct,3157555,3009384,148171,4.7
Tennessee,2016,Nov,3149615,3010463,139152,4.4
Tennessee,2016,Dec,3139789,3001619,138170,4.4
Tennessee,2017,Jan,3145033,2987838,157195,5
Tennessee,2017,Feb,3161986,3020047,141939,4.5
Tennessee,2017,Mar,3174393,3045429,128964,4.1
Tennessee,2017,Apr,3173383,3067480,105903,3.3
Tennessee,2017,May,3172867,3069659,103208,3.3
Tennessee,2017,Jun,3213344,3082899,130445,4.1
Tennessee,2017,Jul,3221926,3094896,127030,3.9
Tennessee,2017,Aug,3193861,3075549,118312,3.7
Tennessee,2017,Sep,3213710,3105538,108172,3.4
Tennessee,2017,Oct,3205521,3099406,106115,3.3
Tennessee,2017,Nov,3204896,3098482,106414,3.3
Tennessee,2017,Dec,3201080,3095818,105262,3.3
Tennessee,2018,Jan,3199020,3072262,126758,4
Tennessee,2018,Feb,3232664,3111237,121427,3.8
Tennessee,2018,Mar,3236419,3120875,115544,3.6
Tennessee,2018,Apr,3234211,3134384,99827,3.1
Tennessee,2018,May,3242736,3142066,100670,3.1
Tennessee,2018,Jun,3283298,3147424,135874,4.1
Tennessee,2018,Jul,3282461,3153273,129188,3.9
Tennessee,2018,Aug,3228446,3109731,118715,3.7
Tennessee,2018,Sep,3238611,3130136,108475,3.3
Tennessee,2018,Oct,3259609,3152814,106795,3.3
Tennessee,2018,Nov,3255813,3157609,98204,3
Tennessee,2018,Dec,3245759,3148104,97655,3
Tennessee,2019,Jan,3266337,3146450,119887,3.7
Tennessee,2019,Feb,3299396,3195236,104160,3.2
Tennessee,2019,Mar,3330614,3220219,110395,3.3
Tennessee,2019,Apr,3336587,3245179,91408,2.7
Tennessee,2019,May,3362925,3260728,102197,3
Tennessee,2019,Jun,3391538,3255545,135993,4
Tennessee,2019,Jul,3403370,3258075,145295,4.3
Tennessee,2019,Aug,3351613,3238650,112963,3.4
Tennessee,2019,Sep,3348862,3244200,104662,3.1
Tennessee,2019,Oct,3354882,3249099,105783,3.2
Texas,2016,Jan,13174872,12589030,585842,4.4
Texas,2016,Feb,13268914,12690637,578277,4.4
Texas,2016,Mar,13309775,12713582,596193,4.5
Texas,2016,Apr,13303438,12739042,564396,4.2
Texas,2016,May,13303271,12735072,568199,4.3
Texas,2016,Jun,13360620,12699793,660827,4.9
Texas,2016,Jul,13400459,12722088,678371,5.1
Texas,2016,Aug,13365223,12700125,665098,5
Texas,2016,Sep,13415467,12753392,662075,4.9
Texas,2016,Oct,13400295,12778902,621393,4.6
Texas,2016,Nov,13438516,12835163,603353,4.5
Texas,2016,Dec,13426884,12816816,610068,4.5
Texas,2017,Jan,13457764,12787348,670416,5
Texas,2017,Feb,13539844,12884992,654852,4.8
Texas,2017,Mar,13561091,12944603,616488,4.5
Texas,2017,Apr,13569065,13006710,562355,4.1
Texas,2017,May,13538934,12975363,563571,4.2
Texas,2017,Jun,13579362,12969342,610020,4.5
Texas,2017,Jul,13615140,13005338,609802,4.5
Texas,2017,Aug,13577833,12968015,609818,4.5
Texas,2017,Sep,13665877,13103482,562395,4.1
Texas,2017,Oct,13605221,13090880,514341,3.8
Texas,2017,Nov,13684985,13149693,535292,3.9
Texas,2017,Dec,13675379,13148165,527214,3.9
Texas,2018,Jan,13689852,13107157,582695,4.3
Texas,2018,Feb,13828682,13255270,573412,4.1
Texas,2018,Mar,13818674,13262592,556082,4
Texas,2018,Apr,13817292,13309876,507416,3.7
Texas,2018,May,13810959,13312236,498723,3.6
Texas,2018,Jun,13866660,13281765,584895,4.2
Texas,2018,Jul,13887986,13320601,567385,4.1
Texas,2018,Aug,13768541,13222420,546121,4
Texas,2018,Sep,13849870,13337031,512839,3.7
Texas,2018,Oct,13901088,13411884,489204,3.5
Texas,2018,Nov,13961940,13475980,485960,3.5
Texas,2018,Dec,13975415,13473628,501787,3.6
Texas,2019,Jan,13986073,13396223,589850,4.2
Texas,2019,Feb,14086922,13537993,548929,3.9
Texas,2019,Mar,14058831,13564159,494672,3.5
Texas,2019,Apr,14000887,13585274,415613,3
Texas,2019,May,13966995,13558482,408513,2.9
Texas,2019,Jun,14041604,13540702,500902,3.6
Texas,2019,Jul,14063720,13539870,523850,3.7
Texas,2019,Aug,14015597,13508829,506768,3.6
Texas,2019,Sep,14113138,13641611,471527,3.3
Texas,2019,Oct,14190783,13723103,467680,3.3
Utah,2016,Jan,1476473,1420376,56097,3.8
Utah,2016,Feb,1484751,1426034,58717,4
Utah,2016,Mar,1489181,1432354,56827,3.8
Utah,2016,Apr,1489348,1437436,51912,3.5
Utah,2016,May,1498032,1447819,50213,3.4
Utah,2016,Jun,1512748,1455084,57664,3.8
Utah,2016,Jul,1518629,1465712,52917,3.5
Utah,2016,Aug,1517585,1465012,52573,3.5
Utah,2016,Sep,1517225,1469470,47755,3.1
Utah,2016,Oct,1522765,1475539,47226,3.1
Utah,2016,Nov,1524750,1480546,44204,2.9
Utah,2016,Dec,1523379,1477407,45972,3
Utah,2017,Jan,1527069,1473023,54046,3.5
Utah,2017,Feb,1533242,1477278,55964,3.7
Utah,2017,Mar,1537404,1483601,53803,3.5
Utah,2017,Apr,1536417,1487012,49405,3.2
Utah,2017,May,1542569,1493207,49362,3.2
Utah,2017,Jun,1555386,1498531,56855,3.7
Utah,2017,Jul,1558868,1506176,52692,3.4
Utah,2017,Aug,1555582,1502447,53135,3.4
Utah,2017,Sep,1555253,1508463,46790,3
Utah,2017,Oct,1557314,1511840,45474,2.9
Utah,2017,Nov,1561708,1517791,43917,2.8
Utah,2017,Dec,1558339,1514378,43961,2.8
Utah,2018,Jan,1555290,1504258,51032,3.3
Utah,2018,Feb,1563401,1510468,52933,3.4
Utah,2018,Mar,1562912,1511642,51270,3.3
Utah,2018,Apr,1560360,1513162,47198,3
Utah,2018,May,1567748,1521885,45863,2.9
Utah,2018,Jun,1578158,1523360,54798,3.5
Utah,2018,Jul,1577161,1526365,50796,3.2
Utah,2018,Aug,1573609,1521268,52341,3.3
Utah,2018,Sep,1575536,1529497,46039,2.9
Utah,2018,Oct,1581739,1536204,45535,2.9
Utah,2018,Nov,1584804,1540781,44023,2.8
Utah,2018,Dec,1584918,1539009,45909,2.9
Utah,2019,Jan,1573827,1524077,49750,3.2
Utah,2019,Feb,1584005,1535322,48683,3.1
Utah,2019,Mar,1585433,1537805,47628,3
Utah,2019,Apr,1582128,1539800,42328,2.7
Utah,2019,May,1588793,1545230,43563,2.7
Utah,2019,Jun,1606335,1554350,51985,3.2
Utah,2019,Jul,1621111,1572185,48926,3
Utah,2019,Aug,1615662,1570188,45474,2.8
Utah,2019,Sep,1612660,1579907,32753,2
Utah,2019,Oct,1620475,1590518,29957,1.8
Vermont,2016,Jan,342293,328767,13526,4
Vermont,2016,Feb,343534,330610,12924,3.8
Vermont,2016,Mar,344198,331388,12810,3.7
Vermont,2016,Apr,341088,329110,11978,3.5
Vermont,2016,May,342940,332322,10618,3.1
Vermont,2016,Jun,348952,337349,11603,3.3
Vermont,2016,Jul,350081,338820,11261,3.2
Vermont,2016,Aug,348219,337532,10687,3.1
Vermont,2016,Sep,343728,333237,10491,3.1
Vermont,2016,Oct,344384,336026,8358,2.4
Vermont,2016,Nov,344452,334370,10082,2.9
Vermont,2016,Dec,343835,334218,9617,2.8
Vermont,2017,Jan,344366,331540,12826,3.7
Vermont,2017,Feb,344424,332133,12291,3.6
Vermont,2017,Mar,345194,333065,12129,3.5
Vermont,2017,Apr,342170,330981,11189,3.3
Vermont,2017,May,343623,333883,9740,2.8
Vermont,2017,Jun,350486,339892,10594,3
Vermont,2017,Jul,351196,340879,10317,2.9
Vermont,2017,Aug,349840,339982,9858,2.8
Vermont,2017,Sep,345346,335761,9585,2.8
Vermont,2017,Oct,345696,338299,7397,2.1
Vermont,2017,Nov,345903,336853,9050,2.6
Vermont,2017,Dec,345379,336993,8386,2.4
Vermont,2018,Jan,345134,333647,11487,3.3
Vermont,2018,Feb,346363,335444,10919,3.2
Vermont,2018,Mar,346762,335929,10833,3.1
Vermont,2018,Apr,342835,332788,10047,2.9
Vermont,2018,May,344092,335426,8666,2.5
Vermont,2018,Jun,349977,340343,9634,2.8
Vermont,2018,Jul,351583,342303,9280,2.6
Vermont,2018,Aug,349489,340710,8779,2.5
Vermont,2018,Sep,343991,335424,8567,2.5
Vermont,2018,Oct,344338,337919,6419,1.9
Vermont,2018,Nov,344435,336217,8218,2.4
Vermont,2018,Dec,343727,335906,7821,2.3
Vermont,2019,Jan,344706,334896,9810,2.8
Vermont,2019,Feb,345774,337106,8668,2.5
Vermont,2019,Mar,345261,337164,8097,2.3
Vermont,2019,Apr,344489,336961,7528,2.2
Vermont,2019,May,346958,340394,6564,1.9
Vermont,2019,Jun,353249,345331,7918,2.2
Vermont,2019,Jul,351492,343804,7688,2.2
Vermont,2019,Aug,346731,339140,7591,2.2
Vermont,2019,Sep,339404,331872,7532,2.2
Vermont,2019,Oct,339228,333794,5434,1.6
Virginia,2016,Jan,4183385,4004564,178821,4.3
Virginia,2016,Feb,4208918,4031663,177255,4.2
Virginia,2016,Mar,4236893,4061884,175009,4.1
Virginia,2016,Apr,4228918,4072015,156903,3.7
Virginia,2016,May,4243246,4079990,163256,3.8
Virginia,2016,Jun,4270405,4087637,182768,4.3
Virginia,2016,Jul,4296728,4112261,184467,4.3
Virginia,2016,Aug,4257895,4070707,187188,4.4
Virginia,2016,Sep,4248466,4069103,179363,4.2
Virginia,2016,Oct,4257186,4084417,172769,4.1
Virginia,2016,Nov,4244521,4080603,163918,3.9
Virginia,2016,Dec,4235526,4073755,161771,3.8
Virginia,2017,Jan,4250969,4065450,185519,4.4
Virginia,2017,Feb,4277497,4099285,178212,4.2
Virginia,2017,Mar,4310185,4141034,169151,3.9
Virginia,2017,Apr,4314025,4164441,149584,3.5
Virginia,2017,May,4321002,4163564,157438,3.6
Virginia,2017,Jun,4345789,4179138,166651,3.8
Virginia,2017,Jul,4366707,4198900,167807,3.8
Virginia,2017,Aug,4317243,4148332,168911,3.9
Virginia,2017,Sep,4328730,4176769,151961,3.5
Virginia,2017,Oct,4306838,4164728,142110,3.3
Virginia,2017,Nov,4295419,4154325,141094,3.3
Virginia,2017,Dec,4280657,4145619,135038,3.2
Virginia,2018,Jan,4279860,4127557,152303,3.6
Virginia,2018,Feb,4322765,4175697,147068,3.4
Virginia,2018,Mar,4336468,4198064,138404,3.2
Virginia,2018,Apr,4331542,4212725,118817,2.7
Virginia,2018,May,4346095,4224455,121640,2.8
Virginia,2018,Jun,4372040,4230750,141290,3.2
Virginia,2018,Jul,4389731,4254838,134893,3.1
Virginia,2018,Aug,4316700,4183057,133643,3.1
Virginia,2018,Sep,4315374,4197256,118118,2.7
Virginia,2018,Oct,4332241,4216960,115281,2.7
Virginia,2018,Nov,4319915,4211391,108524,2.5
Virginia,2018,Dec,4313833,4200865,112968,2.6
Virginia,2019,Jan,4324402,4184632,139770,3.2
Virginia,2019,Feb,4366696,4227372,139324,3.2
Virginia,2019,Mar,4373809,4240825,132984,3
Virginia,2019,Apr,4363922,4254812,109110,2.5
Virginia,2019,May,4400071,4274347,125724,2.9
Virginia,2019,Jun,4442939,4313122,129817,2.9
Virginia,2019,Jul,4483590,4354768,128822,2.9
Virginia,2019,Aug,4432630,4310734,121896,2.7
Virginia,2019,Sep,4414738,4306529,108209,2.5
Virginia,2019,Oct,4444585,4337670,106915,2.4
Washington,2016,Jan,3585375,3363345,222030,6.2
Washington,2016,Feb,3613583,3393255,220328,6.1
Washington,2016,Mar,3630177,3420097,210080,5.8
Washington,2016,Apr,3618915,3429173,189742,5.2
Washington,2016,May,3626629,3441802,184827,5.1
Washington,2016,Jun,3654512,3465650,188862,5.2
Washington,2016,Jul,3670774,3482665,188109,5.1
Washington,2016,Aug,3656566,3472849,183717,5
Washington,2016,Sep,3666474,3488567,177907,4.9
Washington,2016,Oct,3673241,3497814,175427,4.8
Washington,2016,Nov,3666094,3485081,181013,4.9
Washington,2016,Dec,3662029,3476233,185796,5.1
Washington,2017,Jan,3669236,3463581,205655,5.6
Washington,2017,Feb,3691187,3489975,201212,5.5
Washington,2017,Mar,3704384,3518505,185879,5
Washington,2017,Apr,3698101,3534092,164009,4.4
Washington,2017,May,3704936,3538700,166236,4.5
Washington,2017,Jun,3734480,3565786,168694,4.5
Washington,2017,Jul,3753117,3582411,170706,4.5
Washington,2017,Aug,3731629,3559492,172137,4.6
Washington,2017,Sep,3745015,3583881,161134,4.3
Washington,2017,Oct,3733683,3576792,156891,4.2
Washington,2017,Nov,3730125,3559747,170378,4.6
Washington,2017,Dec,3730916,3551022,179894,4.8
Washington,2018,Jan,3736630,3534645,201985,5.4
Washington,2018,Feb,3767711,3569455,198256,5.3
Washington,2018,Mar,3770820,3589027,181793,4.8
Washington,2018,Apr,3759638,3599280,160358,4.3
Washington,2018,May,3770988,3614221,156767,4.2
Washington,2018,Jun,3800402,3634533,165869,4.4
Washington,2018,Jul,3821752,3658505,163247,4.3
Washington,2018,Aug,3793102,3631998,161104,4.2
Washington,2018,Sep,3805427,3654033,151394,4
Washington,2018,Oct,3829284,3673161,156123,4.1
Washington,2018,Nov,3828288,3658424,169864,4.4
Washington,2018,Dec,3833104,3650309,182795,4.8
Washington,2019,Jan,3847064,3644229,202835,5.3
Washington,2019,Feb,3879775,3676546,203229,5.2
Washington,2019,Mar,3892959,3690947,202012,5.2
Washington,2019,Apr,3863466,3692383,171083,4.4
Washington,2019,May,3874335,3713762,160573,4.1
Washington,2019,Jun,3890598,3720698,169900,4.4
Washington,2019,Jul,3927982,3752053,175929,4.5
Washington,2019,Aug,3930463,3752472,177991,4.5
Washington,2019,Sep,3935912,3774484,161428,4.1
Washington,2019,Oct,3959290,3799608,159682,4
West Virginia,2016,Jan,775499,719087,56412,7.3
West Virginia,2016,Feb,782151,722174,59977,7.7
West Virginia,2016,Mar,777651,723443,54208,7
West Virginia,2016,Apr,783207,734230,48977,6.3
West Virginia,2016,May,786465,739911,46554,5.9
West Virginia,2016,Jun,795351,745063,50288,6.3
West Virginia,2016,Jul,790305,743401,46904,5.9
West Virginia,2016,Aug,785787,738747,47040,6
West Virginia,2016,Sep,785787,743332,42455,5.4
West Virginia,2016,Oct,785870,744590,41280,5.3
West Virginia,2016,Nov,777197,737937,39260,5.1
West Virginia,2016,Dec,769628,729966,39662,5.2
West Virginia,2017,Jan,770122,723040,47082,6.1
West Virginia,2017,Feb,774932,726566,48366,6.2
West Virginia,2017,Mar,772243,728771,43472,5.6
West Virginia,2017,Apr,779242,740419,38823,5
West Virginia,2017,May,778549,742568,35981,4.6
West Virginia,2017,Jun,790244,748942,41302,5.2
West Virginia,2017,Jul,786858,746716,40142,5.1
West Virginia,2017,Aug,782345,741172,41173,5.3
West Virginia,2017,Sep,786127,750314,35813,4.6
West Virginia,2017,Oct,783358,747407,35951,4.6
West Virginia,2017,Nov,778148,739769,38379,4.9
West Virginia,2017,Dec,772922,733258,39664,5.1
West Virginia,2018,Jan,771622,724718,46904,6.1
West Virginia,2018,Feb,781287,730278,51009,6.5
West Virginia,2018,Mar,776686,729544,47142,6.1
West Virginia,2018,Apr,783014,740724,42290,5.4
West Virginia,2018,May,785535,746523,39012,5
West Virginia,2018,Jun,795082,751886,43196,5.4
West Virginia,2018,Jul,791543,751018,40525,5.1
West Virginia,2018,Aug,781977,742806,39171,5
West Virginia,2018,Sep,785466,750181,35285,4.5
West Virginia,2018,Oct,788391,752607,35784,4.5
West Virginia,2018,Nov,781723,745973,35750,4.6
West Virginia,2018,Dec,777812,739895,37917,4.9
West Virginia,2019,Jan,782173,735448,46725,6
West Virginia,2019,Feb,789122,740770,48352,6.1
West Virginia,2019,Mar,783668,742302,41366,5.3
West Virginia,2019,Apr,787718,754389,33329,4.2
West Virginia,2019,May,794076,759920,34156,4.3
West Virginia,2019,Jun,807953,768662,39291,4.9
West Virginia,2019,Jul,805966,768974,36992,4.6
West Virginia,2019,Aug,802889,766324,36565,4.6
West Virginia,2019,Sep,806147,772517,33630,4.2
West Virginia,2019,Oct,810483,773965,36518,4.5
Wisconsin,2016,Jan,3090161,2944188,145973,4.7
Wisconsin,2016,Feb,3115903,2959596,156307,5
Wisconsin,2016,Mar,3115270,2965651,149619,4.8
Wisconsin,2016,Apr,3109592,2979527,130065,4.2
Wisconsin,2016,May,3110766,2995492,115274,3.7
Wisconsin,2016,Jun,3170548,3032168,138380,4.4
Wisconsin,2016,Jul,3169032,3040954,128078,4
Wisconsin,2016,Aug,3146646,3027250,119396,3.8
Wisconsin,2016,Sep,3122273,3016492,105781,3.4
Wisconsin,2016,Oct,3125504,3022221,103283,3.3
Wisconsin,2016,Nov,3121291,3018198,103093,3.3
Wisconsin,2016,Dec,3106747,3001037,105710,3.4
Wisconsin,2017,Jan,3104957,2974496,130461,4.2
Wisconsin,2017,Feb,3128758,2990684,138074,4.4
Wisconsin,2017,Mar,3125882,3003908,121974,3.9
Wisconsin,2017,Apr,3124176,3023569,100607,3.2
Wisconsin,2017,May,3126768,3033941,92827,3
Wisconsin,2017,Jun,3188610,3074277,114333,3.6
Wisconsin,2017,Jul,3188692,3081127,107565,3.4
Wisconsin,2017,Aug,3160790,3057930,102860,3.3
Wisconsin,2017,Sep,3146403,3062870,83533,2.7
Wisconsin,2017,Oct,3137292,3058953,78339,2.5
Wisconsin,2017,Nov,3133862,3051980,81882,2.6
Wisconsin,2017,Dec,3118734,3035703,83031,2.7
Wisconsin,2018,Jan,3109025,3004625,104400,3.4
Wisconsin,2018,Feb,3143901,3025754,118147,3.8
Wisconsin,2018,Mar,3135185,3023279,111906,3.6
Wisconsin,2018,Apr,3124037,3031321,92716,3
Wisconsin,2018,May,3129532,3044465,85067,2.7
Wisconsin,2018,Jun,3188170,3076512,111658,3.5
Wisconsin,2018,Jul,3178978,3078816,100162,3.2
Wisconsin,2018,Aug,3134631,3043293,91338,2.9
Wisconsin,2018,Sep,3112050,3038413,73637,2.4
Wisconsin,2018,Oct,3121149,3046415,74734,2.4
Wisconsin,2018,Nov,3116247,3038702,77545,2.5
Wisconsin,2018,Dec,3106624,3019941,86683,2.8
Wisconsin,2019,Jan,3104064,2995710,108354,3.5
Wisconsin,2019,Feb,3118580,3014575,104005,3.3
Wisconsin,2019,Mar,3121546,3018738,102808,3.3
Wisconsin,2019,Apr,3106510,3023665,82845,2.7
Wisconsin,2019,May,3086559,3002539,84020,2.7
Wisconsin,2019,Jun,3161408,3050577,110831,3.5
Wisconsin,2019,Jul,3169995,3061206,108789,3.4
Wisconsin,2019,Aug,3146641,3041351,105290,3.3
Wisconsin,2019,Sep,3108570,3017169,91401,2.9
Wisconsin,2019,Oct,3112283,3026370,85913,2.8
Wyoming,2016,Jan,300864,282894,17970,6
Wyoming,2016,Feb,300604,282957,17647,5.9
Wyoming,2016,Mar,302181,283984,18197,6
Wyoming,2016,Apr,301438,283402,18036,6
Wyoming,2016,May,301416,284229,17187,5.7
Wyoming,2016,Jun,306601,289514,17087,5.6
Wyoming,2016,Jul,305042,289577,15465,5.1
Wyoming,2016,Aug,302117,287811,14306,4.7
Wyoming,2016,Sep,298694,284969,13725,4.6
Wyoming,2016,Oct,297972,284367,13605,4.6
Wyoming,2016,Nov,296667,282374,14293,4.8
Wyoming,2016,Dec,295187,280096,15091,5.1
Wyoming,2017,Jan,292219,276506,15713,5.4
Wyoming,2017,Feb,291469,277262,14207,4.9
Wyoming,2017,Mar,292420,278688,13732,4.7
Wyoming,2017,Apr,290679,278664,12015,4.1
Wyoming,2017,May,291595,280113,11482,3.9
Wyoming,2017,Jun,297983,285787,12196,4.1
Wyoming,2017,Jul,297502,286172,11330,3.8
Wyoming,2017,Aug,295458,284672,10786,3.7
Wyoming,2017,Sep,293066,282330,10736,3.7
Wyoming,2017,Oct,292317,281329,10988,3.8
Wyoming,2017,Nov,291462,279511,11951,4.1
Wyoming,2017,Dec,288903,277228,11675,4
Wyoming,2018,Jan,287515,273620,13895,4.8
Wyoming,2018,Feb,287190,274219,12971,4.5
Wyoming,2018,Mar,288281,275517,12764,4.4
Wyoming,2018,Apr,287157,275538,11619,4
Wyoming,2018,May,288015,276880,11135,3.9
Wyoming,2018,Jun,294706,282637,12069,4.1
Wyoming,2018,Jul,294534,283267,11267,3.8
Wyoming,2018,Aug,292187,281500,10687,3.7
Wyoming,2018,Sep,289631,278938,10693,3.7
Wyoming,2018,Oct,289628,278797,10831,3.7
Wyoming,2018,Nov,289088,277501,11587,4
Wyoming,2018,Dec,286957,275430,11527,4
Wyoming,2019,Jan,287570,274679,12891,4.5
Wyoming,2019,Feb,287199,276222,10977,3.8
Wyoming,2019,Mar,287758,276831,10927,3.8
Wyoming,2019,Apr,285196,275698,9498,3.3
Wyoming,2019,May,285315,275782,9533,3.3
Wyoming,2019,Jun,292616,281459,11157,3.8
Wyoming,2019,Jul,293911,282720,11191,3.8
Wyoming,2019,Aug,292452,282314,10138,3.5
Wyoming,2019,Sep,292446,282731,9715,3.3
Wyoming,2019,Oct,293236,283656,9580,3.3